StarWords
An Interactive Fiction by Campbell Burgess
Release 1 / Serial number 130823 / Inform 7 build 6G60 (I6/v6.32 lib 6/12N) SD

training room
A place to practice jedi skills.  There is a door to the north and an exit to the south

There is a bench by the wall.

Drong is here.

Yoda is here.

>test all
(Testing.)

>[1] test table
(Testing.)

>[2] open left drawer
You open the left drawer, revealing a D battery.

>[3] open right drawer
You open the right drawer, revealing a light sabre.

>[4] get d battery
Taken.

>[5] get sabre
Taken.

>[6] kill yoda with sabre
With what?

>[7] test sabre
(Testing.)

>[8] get sabre
You already have that.

>[9] open it
You open the light sabre's battery compartment.

>[10] put battery in it
(the D battery in the light sabre)
You put the D battery into the light sabre's battery compartment.

>[11] press button
It is now on.

>[12] test fight
(Testing.)

>[13] attack yoda with sabre
Yoda drops under your blow then tells you to trust the force.

>[14] again
Yoda paries your thrust with a smile and a playful kick in the ass.

>[15] again
Yoda blocks your advance then tells you to trust the force.

>[16] again
Yoda is surprised momentarilly by your feint, but recovers with a smile and a playful kick in the ass.

>[17] again
Yoda paries your thrust then tells you to trust the force.
Yoda says "You're training is now complete!".  The force feels stronger in you now.

>[18] s

Arena
Sand, blood, iron. These festivals are normally held on hot days, but the sun has gone behind a cloud and fat drops of rain now and then spatter the arena floor.

A clone warrior faces you, wielding a laser rifle and a blaster.

A bounty hunter circles you, pointing a shock rifle and a bounty blaster.

The clone warrior attacks you with the blaster, causing 1 point of damage!

The bounty hunter attacks you with the bounty blaster, causing 2 points of damage!

>look
Arena
Sand, blood, iron. These festivals are normally held on hot days, but the sun has gone behind a cloud and fat drops of rain now and then spatter the arena floor.

A clone warrior faces you, wielding a laser rifle and a blaster.

A bounty hunter circles you, pointing a shock rifle and a bounty blaster.

The clone warrior attacks you with the blaster, causing 0 points of damage!

The bounty hunter attacks you with the bounty blaster, causing 0 points of damage!

>look
Arena
Sand, blood, iron. These festivals are normally held on hot days, but the sun has gone behind a cloud and fat drops of rain now and then spatter the arena floor.

A clone warrior faces you, wielding a laser rifle and a blaster.

A bounty hunter circles you, pointing a shock rifle and a bounty blaster.

The clone warrior attacks you with the laser rifle, causing 4 points of damage!

The bounty hunter attacks you with the shock rifle, causing 4 points of damage!

>look
Arena
Sand, blood, iron. These festivals are normally held on hot days, but the sun has gone behind a cloud and fat drops of rain now and then spatter the arena floor.

A clone warrior faces you, wielding a laser rifle and a blaster.

A bounty hunter circles you, pointing a shock rifle and a bounty blaster.

The clone warrior attacks you with the laser rifle, causing 0 points of damage!

The bounty hunter attacks you with the shock rifle, causing 6 points of damage!

>look
Arena
Sand, blood, iron. These festivals are normally held on hot days, but the sun has gone behind a cloud and fat drops of rain now and then spatter the arena floor.

A clone warrior faces you, wielding a laser rifle and a blaster.

A bounty hunter circles you, pointing a shock rifle and a bounty blaster.

The clone warrior attacks you with the blaster, causing 4 points of damage!

The bounty hunter attacks you with the shock rifle, causing 5 points of damage!

>kill hunter with sabre
You attack with the light sabre, killing the bounty hunter!

The clone warrior attacks you with the blaster, causing 3 points of damage!

>kill clone with sabre
You attack the clone warrior with the light sabre, causing 15 points of damage!

The clone warrior attacks you with the blaster, causing 5 points of damage!

The light sabre is obviously going to go out quite soon.

>again
You attack with the light sabre, killing the clone warrior!

>again
You can't see any such thing.

>look
Arena
Sand, blood, iron. These festivals are normally held on hot days, but the sun has gone behind a cloud and fat drops of rain now and then spatter the arena floor.

The light sabre loses power and switches off!

It is now off.

It is now pitch dark in here!

* * *

>kill hunter with sabre
You attack with the light sabre, killing the bounty hunter!

The clone warrior attacks you with the laser rifle, causing 0 points of damage!

>kill hunter with sabre
You can't see any such thing.

>kill clone with sabre
You attack the clone warrior with the light sabre, causing 10 points of damage!

The clone warrior attacks you with the laser rifle, causing 3 points of damage!

>again
You attack with the light sabre, killing the clone warrior!

* * *

>kill hunter with sabre
You attack with the light sabre, killing the bounty hunter!

The clone warrior attacks you with the laser rifle, causing 0 points of damage!

>again
You attack with the light sabre, killing the bounty hunter!

The clone warrior attacks you with the laser rifle, causing 1 point of damage!

>kill clone with sabre
You attack the clone warrior with the light sabre, causing 6 points of damage!

The clone warrior attacks you with the blaster, causing 4 points of damage!

>again
You attack the clone warrior with the light sabre, causing 1 point of damage!

The clone warrior attacks you with the blaster, causing 3 points of damage!

>again
You attack the clone warrior with the light sabre, causing 12 points of damage!

The clone warrior attacks you with the blaster, causing 4 points of damage!

>again
You attack with the light sabre, killing the clone warrior!

The light sabre is obviously going to go out quite soon.

>x sabre
It's blade is glowing blue.

The light sabre is currently switched on.

>z
Time passes.

The light sabre loses power and switches off!

It is now off.

It is now pitch dark in here!

>n
training room
A place to practice jedi skills.  There is a door to the north and an exit to the south

There is a bench by the wall.

Drong is here.

Yoda is here.

>s
Darkness
It is pitch dark, and you can't see a thing.

>n
training room
A place to practice jedi skills.  There is a door to the north and an exit to the south

There is a bench by the wall.

Drong is here.

Yoda is here.

>n
Darkness
It is pitch dark, and you can't see a thing.

>d
You can't go that way.

* * *

StarWords
An Interactive Fiction by Campbell Burgess
Release 1 / Serial number 130823 / Inform 7 build 6G60 (I6/v6.32 lib 6/12N) SD

training room
A place to practice jedi skills.  There is a door to the north and an exit to the south

There is a bench by the wall.

Drong is here.

Yoda is here.

>n
Darkness
It is pitch dark, and you can't see a thing.

the arena is dark

* * *

StarWords
An Interactive Fiction by Campbell Burgess
Release 1 / Serial number 130823 / Inform 7 build 6G60 (I6/v6.32 lib 6/12N) SD

training room
A place to practice jedi skills.  There is a door to the north and an exit to the south

There is a bench by the wall.

Drong is here.

Yoda is here.

>test table
(Testing.)

>[1] open left drawer
You open the left drawer, revealing a D battery.

>[2] open right drawer
You open the right drawer, revealing a light sabre.

>[3] get d battery
Taken.

>[4] get sabre
Taken.

>[5] kill yoda with sabre
With what?

>test sabre
(Testing.)

>[1] get sabre
You already have that.

>[2] open it
You open the light sabre's battery compartment.

>[3] put battery in it
(the D battery in the light sabre)
You put the D battery into the light sabre's battery compartment.

>attack yoda with sabre
With what?

>press button
It is now on.

>attack yoda with sabre
Yoda drops under your blow and suggests you loosen your grip.

>again
Yoda is surprised momentarilly by your feint, but recovers then tells you to trust the force.

>again
Yoda blocks your advance with a smile and a playful kick in the ass.

>again
Yoda drops under your blow and suggests you loosen your grip.

>again
Yoda paries your thrust with a smile and a playful kick in the ass.
Yoda says "You're training is now complete!".  The force feels stronger in you now. 2

* * *

>test sabre
(Testing.)

>[1] get sabre
You already have that.

>[2] open it
You open the light sabre's battery compartment.

>[3] put battery in it
(the D battery in the light sabre)
You put the D battery into the light sabre's battery compartment.

>press button
It is now on.

>s
Arena
Sand, blood, iron. These festivals are normally held on hot days, but the sun has gone behind a cloud and fat drops of rain now and then spatter the arena floor.

A clone warrior faces you, wielding a laser rifle and a blaster.

A bounty hunter circles you, pointing a shock rifle and a bounty blaster.

>s
You can't go that way.

I beg your pardon?

>look
Arena
Sand, blood, iron. These festivals are normally held on hot days, but the sun has gone behind a cloud and fat drops of rain now and then spatter the arena floor.

A clone warrior faces you, wielding a laser rifle and a blaster.

A bounty hunter circles you, pointing a shock rifle and a bounty blaster.

* * *

>s
Arena
Sand, blood, iron. These festivals are normally held on hot days, but the sun has gone behind a cloud and fat drops of rain now and then spatter the arena floor.

A clone warrior faces you, wielding a laser rifle and a blaster.

A bounty hunter circles you, pointing a shock rifle and a bounty blaster.

>look
Arena
Sand, blood, iron. These festivals are normally held on hot days, but the sun has gone behind a cloud and fat drops of rain now and then spatter the arena floor.

A clone warrior faces you, wielding a laser rifle and a blaster.

A bounty hunter circles you, pointing a shock rifle and a bounty blaster.

* * *

>test table
(Testing.)

>[1] open left drawer
You open the left drawer, revealing a D battery.

>[2] open right drawer
You open the right drawer, revealing a light sabre.

>[3] get d battery
Taken.

>[4] get sabre
Taken.

>[5] kill yoda with sabre
With what?

>attack yoda with sabre
You missed Yoda

* * *

>test table
(Testing.)

>[1] open left drawer
You open the left drawer, revealing a D battery.

>[2] open right drawer
You open the right drawer, revealing a light sabre.

>[3] get d battery
Taken.

>[4] get sabre
Taken.

>[5] kill yoda with sabre
With what?

>kill Drong with sabre
Drong paries your thrust with a smile and a playful kick in the ass.

* * *

>test table
(Testing.)

>[1] open left drawer
You open the left drawer, revealing a D battery.

>[2] open right drawer
You open the right drawer, revealing a light sabre.

>[3] get d battery
Taken.

>[4] get sabre
Taken.

>[5] kill yoda with sabre
With what?

>again
Yoda drops under your blow and suggests you loosen your grip.

>agin
That's not a verb I recognise.

>again
That's not a verb I recognise.

>hit yoda with sabre
Yoda drops under your blow and suggests you loosen your grip.

>again
Yoda blocks your advance then tells you to trust the force.

>again
Yoda paries your thrust with a smile and a playful kick in the ass.
Yoda says "You're training is now complete!".  The force feels stronger in you now.

>again
Yoda drops under your blow and suggests you loosen your grip.

>showme player
There seems to be no such object anywhere in the model world.

>showme
training room - room
    yourself - person
        light sabre - light source
            on/off button (part of light sabre)
            light sabre's battery compartment (part of light sabre) - battery compartment
        D battery - battery
        backpack (worn) - open container
            flashlight - light source
                flashlight's battery compartment (part of flashlight) - battery compartment
                red cellophane (part of flashlight)
            cassette recorder - device
                cassette recorder's battery compartment (part of cassette recorder) - battery compartment
    bench
        left drawer (part of bench) - open container
        right drawer (part of bench) - open container
    Drong - friendly
    Yoda - friendly

* * *

>again
Yoda drops under your blow and suggests you loosen your grip.

>again
Yoda paries your thrust with a smile and a playful kick in the ass.

>again
Yoda is surprised momentarilly by your feint, but recovers then tells you to trust the force.

>again
Yoda paries your thrust with a smile and a playful kick in the ass.
Yoda says "You're training is now complete!".  The force feels stronger in you now.

>s
Arena
Sand, blood, iron. These festivals are normally held on hot days, but the sun has gone behind a cloud and fat drops of rain now and then spatter the arena floor.

A clone warrior faces you, wielding a laser rifle and a blaster.

A bounty hunter circles you, pointing a shock rifle and a bounty blaster.

>kill clone with sabre
You missed the clone warrior

>again
You missed the clone warrior

* * *

>again
Yoda paries your thrust with a smile and a playful kick in the ass.
Yoda says "You're training is now complete!".  The force feels stronger in you now.

>again
Yoda is surprised momentarilly by your feint, but recovers and suggests you loosen your grip.
Yoda says "You're training is now complete!"

* * *

>test table
(Testing.)

>[1] open left drawer
You open the left drawer, revealing a D battery.

>[2] open right drawer
You open the right drawer, revealing a light sabre.

>[3] get d battery
Taken.

>[4] get sabre
Taken.

>[5] kill yoda with sabre
With what?

>test yoda
>--> The following tests are available:
'test gladiator'
'test table'
'test me'
'test first'
'test second'
'test sabre'

>test sabe
>--> The following tests are available:
'test gladiator'
'test table'
'test me'
'test first'
'test second'
'test sabre'

>test sabre
(Testing.)

>[1] get sabre
You already have that.

>[2] open it
You open the light sabre's battery compartment.

>[3] put battery in it
(the D battery in the light sabre)
You put the D battery into the light sabre's battery compartment.

* * *

>press button
It is now on.

>attack yoda with sabre
Yoda blocks your advance then tells you to trust the force.

>again
Yoda is surprised momentarilly by your feint, but recovers with a smile and a playful kick in the ass.

>again
Yoda paries your thrust then tells you to trust the force.

>again
Yoda drops under your blow with a smile and a playful kick in the ass.

>again
Yoda paries your thrust and suggests you loosen your grip.
Yoda says "You're training is now complete!".  The force feels stronger in you now.

>s
Arena
Sand, blood, iron. These festivals are normally held on hot days, but the sun has gone behind a cloud and fat drops of rain now and then spatter the arena floor.

A clone warrior faces you, wielding a laser rifle and a blaster.

A bounty hunter circles you, pointing a shock rifle and a bounty blaster.

>kill hunter with sabre
You attack the bounty hunter with the light sabre, causing 19 points of damage!

>again
You attack with the light sabre, killing the bounty hunter!

>again
You can't see any such thing.

* * *

>test table
(Testing.)

>[1] open left drawer
You open the left drawer, revealing a D battery.

>[2] open right drawer
You open the right drawer, revealing a light sabre.

>[3] get d battery
Taken.

>[4] get sabre
Taken.

>[5] kill yoda with sabre
With what?

>kill yoda with sabe
You can't see any such thing.

>kill yoda with sabre
OOps

* * *

>test table
(Testing.)

>[1] open left drawer
You open the left drawer, revealing a D battery.

>[2] open right drawer
You open the right drawer, revealing a light sabre.

>[3] get d battery
Taken.

>[4] get sabre
Taken.

>[5] kill yoda with sabre
With what?

>kill yoda with sabre
OOpsYou missed Yoda

* * *

StarWords
An Interactive Fiction by Campbell Burgess
Release 1 / Serial number 130823 / Inform 7 build 6G60 (I6/v6.32 lib 6/12N) SD

training room
A place to practice jedi skills.  There is a door to the north and an exit to the south

There is a bench by the wall.

Drong is here.

Yoda is here.

>test tabel
>--> The following tests are available:
'test gladiator'
'test table'
'test me'
'test first'
'test second'
'test sabre'

* * *

StarWords
An Interactive Fiction by Campbell Burgess
Release 1 / Serial number 130823 / Inform 7 build 6G60 (I6/v6.32 lib 6/12N) SD

training room
A place to practice jedi skills.  There is a door to the north and an exit to the south

There is a bench by the wall.

Drong is here.

Yoda is here.

>s
Darkness
It is pitch dark, and you can't see a thing.

* * *

>n
Darkness
It is pitch dark, and you can't see a thing.

>s
training room
A place to practice jedi skills.  There is a door to the north and an exit to the south

There is a bench by the wall.

Drong is here.

Yoda is here.

>e
You can't go that way.

* * *

>w
You can't go that way.

>s
Darkness
It is pitch dark, and you can't see a thing.

* * *

>w
You can't go that way.

>n
training room
A place to practice jedi skills.  There is a door to the north and an exit to the south

There is a bench by the wall.

Drong is here.

Yoda is here.

>x bench
It is an ordinary bench with two drawers, left and right

>open left draw
I only understood you as far as wanting to open the left drawer.

>open left drawer
You open the left drawer, revealing a D battery.

* * *

>get sabre
Taken.

>x sabre
The light sabre has in on/off switch at the hilt.

The light sabre is currently switched off.

>turn on
(the light sabre)
Nothing happens, perhaps because there isn't a charged battery in the light sabre.

>open it
You open the light sabre's battery compartment.

>put d in it
(down in the light sabre)
You must name something more substantial.

>put battery in it
(the D battery in down)
You must name something more substantial.

>put battery in sabre
(the D battery in the light sabre)
You put the D battery into the light sabre's battery compartment.

>close it
That's not something you can close.

>close sabre
You close the light sabre's battery compartment.

>turn it on
It is now on.

>x sabre
It's blade is glowing blue.

The light sabre is currently switched on.

>s
Arena
Sand, blood, iron. These festivals are normally held on hot days, but the sun has gone behind a cloud and fat drops of rain now and then spatter the arena floor.

A clone warrior faces you, wielding a laser rifle and a blaster.

A bounty hunter circles you, pointing a shock rifle and a bounty blaster.

The clone warrior attacks you with the blaster, causing 4 points of damage!

The bounty hunter attacks you with the bounty blaster, causing 0 points of damage!

>n
training room
A place to practice jedi skills.  There is a door to the north and an exit to the south

There is a bench by the wall.

Drong is here.

Yoda is here.

>n
Dead End
This is a dead end. You'll have to go back the way you came.

>s
training room
A place to practice jedi skills.  There is a door to the north and an exit to the south

There is a bench by the wall.

Drong is here.

Yoda is here.

>s
Arena
Sand, blood, iron. These festivals are normally held on hot days, but the sun has gone behind a cloud and fat drops of rain now and then spatter the arena floor.

A clone warrior faces you, wielding a laser rifle and a blaster.

A bounty hunter circles you, pointing a shock rifle and a bounty blaster.

The clone warrior attacks you with the blaster, causing 3 points of damage!

The bounty hunter attacks you with the shock rifle, causing 2 points of damage!

>hit clone with it
You can't see "it" (the bench) at the moment.

>hit clone with sabre
You attack the clone warrior with the light sabre, causing 2 points of damage!

The clone warrior attacks you with the laser rifle, causing 6 points of damage!

The bounty hunter attacks you with the shock rifle, causing 2 points of damage!

>save
Please supply a filename for save
Ok.

>again
Please supply a filename for save
(Save failed, reason unknown)
Save failed.

>hit clone with sabre
You missed the clone warrior
The clone warrior attacks you with the laser rifle, causing 4 points of damage!

The bounty hunter attacks you with the shock rifle, causing 2 points of damage!

>hit clone with sabre
You attack the clone warrior with the light sabre, causing 5 points of damage!

The clone warrior attacks you with the blaster, causing 4 points of damage!

The bounty hunter attacks you with the bounty blaster, causing 0 points of damage!

>hit clone with sabre
You attack the clone warrior with the light sabre, causing 8 points of damage!

The clone warrior attacks you with the blaster, causing 2 points of damage!

*** Run-time problem P43: Attempt to remove the player from play.

The bounty hunter attacks you with the shock rifle, finishing you off!

    *** The End ***

In that game you scored 0 out of a possible 0, in 35 turns.

Would you like to RESTART, RESTORE a saved game, QUIT or UNDO the last command?

>restore
Please supply a filename for restore
Ok.

>look
Arena
Sand, blood, iron. These festivals are normally held on hot days, but the sun has gone behind a cloud and fat drops of rain now and then spatter the arena floor.

A clone warrior faces you, wielding a laser rifle and a blaster.

A bounty hunter circles you, pointing a shock rifle and a bounty blaster.

The clone warrior attacks you with the laser rifle, causing 0 points of damage!

The bounty hunter attacks you with the bounty blaster, causing 5 points of damage!

>restore
Please supply a filename for restore
Ok.

>n
training room
A place to practice jedi skills.  There is a door to the north and an exit to the south

There is a bench by the wall.

Drong is here.

Yoda is here.

>get drong
I don't suppose Drong would care for that.

>train drng
That's not a verb I recognise.

>train drong
That's not a verb I recognise.

>fight drong
Violence isn't the answer to this one.

>hit drong
What do you want to hit Drong with?

>hit drong with light sabre
Drong drops under your blow then tells you to trust the force.

>hit drong with light sabre
Drong paries your thrust and suggests you loosen your grip.

The light sabre is obviously going to go out quite soon.

>hit drong with light sabre
Drong blocks your advance with a smile and a playful kick in the ass.

>hit drong with light sabre
You attack with the light sabre, killing Drong!

The light sabre loses power and switches off!

It is now off.

>look
training room
A place to practice jedi skills.  There is a door to the north and an exit to the south

There is a bench by the wall.

Yoda is here.