StarWords
An Interactive Fiction by Campbell Burgess
Release 1 / Serial number 130924 / Inform 7 build 6G60 (I6/v6.32 lib 6/12N) SD

Training Room
A place to practice jedi skills.  There is a door to the north and an exit to the south. There is a bench by the wall.

The groom, Maud is here.

Drong is here.

Yoda is here.

>yoda track me
That's not a verb I recognise.

* * *

StarWords
An Interactive Fiction by Campbell Burgess
Release 1 / Serial number 130924 / Inform 7 build 6G60 (I6/v6.32 lib 6/12N) SD

Training Room
A place to practice jedi skills.  There is a door to the north and an exit to the south. There is a bench by the wall.

The groom, Maud is here.

Drong is here.

Yoda is here.

>yoda, fight me
(with the green light sabre)
Yoda  says "I will not fight you, my friend.

Yoda is unable to do that.

* * *

StarWords
An Interactive Fiction by Campbell Burgess
Release 1 / Serial number 130924 / Inform 7 build 6G60 (I6/v6.32 lib 6/12N) SD

Training Room
A place to practice jedi skills.  There is a door to the north and an exit to the south. There is a bench by the wall.

The groom, Maud is here.

Drong is here.

Yoda is here.

>yoda, fight yoda
(with the green light sabre)
Yoda  says "Don't be absurd."

Yoda is unable to do that.

* * *

StarWords
An Interactive Fiction by Campbell Burgess
Release 1 / Serial number 130924 / Inform 7 build 6G60 (I6/v6.32 lib 6/12N) SD

Training Room
A place to practice jedi skills.  There is a door to the north and an exit to the south. There is a bench by the wall.

The groom, Maud is here.

Drong is here.

Yoda is here.

>maude, go s
You seem to want to talk to someone, but I can't see whom.

>maud, go s
*** Run-time problem P10: Since the south is not allowed the property "suggestion", it is against the rules to try to use it.

murmours "I feel compelled to … going .. the south"
Maud goes south.

* * *

StarWords
An Interactive Fiction by Campbell Burgess
Release 1 / Serial number 130924 / Inform 7 build 6G60 (I6/v6.32 lib 6/12N) SD

Training Room
A place to practice jedi skills.  There is a door to the north and an exit to the south. There is a bench by the wall.

The groom, Maud is here.

Drong is here.

Yoda is here.

>yoda, track me
Yoda tracks yourself

* * *

StarWords
An Interactive Fiction by Campbell Burgess
Release 1 / Serial number 130924 / Inform 7 build 6G60 (I6/v6.32 lib 6/12N) SD

Training Room
A place to practice jedi skills.  There is a door to the north and an exit to the south. There is a bench by the wall.

The groom, Maud is here.

Drong is here.

Yoda is here.

>drong, spar with me
(with the blue light sabre)
Drong spars with yourself with the blue light sabre
Drong's experience points increases by -1.

* * *

StarWords
An Interactive Fiction by Campbell Burgess
Release 1 / Serial number 130924 / Inform 7 build 6G60 (I6/v6.32 lib 6/12N) SD

Training Room
A place to practice jedi skills.  There is a door to the north and an exit to the south. There is a bench by the wall.

The groom, Maud is here.

Drong is here.

Yoda is here.

>drong, spar with yoda
(with the blue light sabre)
Drong says "I would prefer to spar with you!"

Drong spars with Yoda with the blue light sabre
Drong's experience points increases by 1.

* * *

StarWords
An Interactive Fiction by Campbell Burgess
Release 1 / Serial number 130924 / Inform 7 build 6G60 (I6/v6.32 lib 6/12N) SD

Training Room
A place to practice jedi skills.  There is a door to the north and an exit to the south. There is a bench by the wall.

The groom, Maud is here.

Drong is here.

Yoda is here.

>maud, go n
murmours "I feel compelled to … going .. the north"
Maud goes north.

* * *

>s
Darkness
It is pitch dark, and you can't see a thing.

The clone warrior fixes on you, menacing a laser rifle and a clone blaster.
The bounty hunter turns to face you, wielding a shock rifle and a bounty blaster.

Arena
Sand, blood, iron. These festivals are normally held on hot days, but the sun has gone behind a cloud and fat drops of rain now and then spatter the arena floor.

Keav is here.

A clone of the Empire is here.

One of Jabba's bounty hunters is here.

>clone, kill hunter with laser rifle
mutters "I need to … attacking it with .. the bounty hunter"
the clone warrior says "The bounty hunter is a friend. I would sooner fight you!"

The clone warrior is unable to do that.

Keav attacks the clone warrior with the light sabre, causing 4 points of damage!

The clone warrior attacks Keav with the clone blaster, causing 4 points of damage!

The bounty hunter attacks you with the shock rifle, causing 4 points of damage!

Drong arrives from the north.

>clone, follow me
mutters "I need to … following .. yourself"
The clone warrior says "Ok, I will follow you."

Drong attacks the bounty hunter with the light sabre, causing 0 points of damage!

Keav attacks the bounty hunter with the light sabre, causing 10 points of damage!

The clone warrior attacks Keav with the laser rifle, causing 3 points of damage!

The bounty hunter attacks Drong with the bounty blaster, causing 5 points of damage!

>n
Training Room
A place to practice jedi skills.  There is a door to the north and an exit to the south. There is a bench by the wall.

Keav arrives from the south.

The clone warrior arrives from the south.

>look
Training Room
A place to practice jedi skills.  There is a door to the north and an exit to the south. There is a bench by the wall.

A clone of the Empire is here.

Keav is here.

The clone warrior attacks you with the clone blaster, causing 2 points of damage!

Keav attacks the clone warrior with the light sabre, causing 2 points of damage!

Drong arrives from the south.

>become clonw
You can't see any such thing.

>become clone
(the clone warrior)
You can only "become" an ally, and the clone warrior is NOT an ally of yours.

Drong attacks the clone warrior with the light sabre, causing 0 points of damage!

The clone warrior attacks you with the clone blaster, causing 2 points of damage!

Keav attacks the clone warrior with the light sabre, causing 9 points of damage!

* * *

StarWords
An Interactive Fiction by Campbell Burgess
Release 1 / Serial number 130924 / Inform 7 build 6G60 (I6/v6.32 lib 6/12N) SD

Training Room
A place to practice jedi skills.  There is a door to the north and an exit to the south. There is a bench by the wall.

The groom, Maud is here.

Drong is here.

Yoda is here.

>Yoda, follow me
Yoda says "Ok, I will follow yourself."

* * *

StarWords
An Interactive Fiction by Campbell Burgess
Release 1 / Serial number 130924 / Inform 7 build 6G60 (I6/v6.32 lib 6/12N) SD

Training Room
A place to practice jedi skills.  There is a door to the north and an exit to the south. There is a bench by the wall.

The groom, Maud is here.

Drong is here.

Yoda is here.

>test tbale
>--> The following tests are available:
'test table'
'test me'
'test first'
'test second'
'test sabre'
'test spar'
'test all'

>test table
(Testing.)

>[1] open left drawer
You open the left drawer, revealing a light sabre.

>[2] open right drawer
You open the right drawer, revealing a battery.

>[3] get battery
(a battery)
Taken.

>[4] get sabre
Taken.

>[5] put battery in sabre
(a battery in the light sabre)
(first opening the light sabre)
(then closing the light sabre's battery compartment)

>[6] press button
The light sabre's blade now glows blue.

>s
Arena
Sand, blood, iron. These festivals are normally held on hot days, but the sun has gone behind a cloud and fat drops of rain now and then spatter the arena floor.

A clone of the Empire is here.

One of Jabba's bounty hunters is here.

OFFGUARD
OFFGUARD

* * *

>spar with yoda
(with the light sabre)
Yoda performs an elegant backflip to avoid your well aimed stroke.
Yoda says "Blind we are, if creation of this clone army we could not see."

Your experience points increases by 5.  
"pop"

>spar with yoda
(with the light sabre)
Yoda side steps your clumsy maneuver.
Yoda says "Train yourself to let go of everything you fear to lose."

Your experience points increases by 2.  Yoda says "You're training is now complete!".  The force feels stronger in you now.  Drong will be you new padawan, Master Keav
"vrrrm"

>spar with yoda
(with the light sabre)
Yoda easilly evades your reach.
Yoda says "I cannot teach him. The boy has no patience."

Your experience points increases by 4.  
"hrrrm"

I beg your pardon?

>spar with yoda
(with the light sabre)
Yoda side steps your clumsy maneuver.
Yoda says "I cannot teach him. The boy has no patience."

Your experience points increases by 3.  
"pop"

>spar with yoda
(with the light sabre)
Yoda strikes like a viper while seeming to hover outside your range.
Yoda says "Blind we are, if creation of this clone army we could not see."

Your experience points increases by 1.  Yoda says "You're training is now complete!".  The force feels stronger in you now.  Drong will be you new padawan, Master Keav
"snap"

>yoda, follow me
"Yes, master jedi."
Yoda says "Ok, I will follow you."

"vrrrm"

>become yoda
I feel quite Yoda-ish now.

>maud, go s
murmours "I feel compelled to … going .. the south"
Maud goes south.

>s
Darkness
It is pitch dark, and you can't see a thing.

The clone warrior turns to face you, wielding a laser rifle and a clone blaster.
The bounty hunter fixes on you, pointing a shock rifle and a bounty blaster.

Arena
Sand, blood, iron. These festivals are normally held on hot days, but the sun has gone behind a cloud and fat drops of rain now and then spatter the arena floor.

Keav is here.

The groom, Maud is here.

A clone of the Empire is here.

One of Jabba's bounty hunters is here.

>clone, kill bounty hunter with laser rifle
murmours "I feel compelled to … attacking it with .. the bounty hunter"
the clone warrior says "The bounty hunter is a friend. I would sooner fight you!"

The clone warrior is unable to do that.

Keav attacks the bounty hunter with the light sabre, causing 1 point of damage!

The clone warrior attacks Keav with the laser rifle, causing 0 points of damage!

The bounty hunter attacks Keav with the shock rifle, causing 3 points of damage!

Drong arrives from the north.

>become keave
You can't see any such thing.

>become keav
I feel quite Keav-ish now.

Drong attacks the bounty hunter with the light sabre, causing 0 points of damage!

Yoda turns to face the bounty hunter, menacing a light sabre.

The clone warrior attacks Yoda with the laser rifle, causing 5 points of damage!

The bounty hunter attacks Drong with the bounty blaster, causing 3 points of damage!

>clone, kill bounty hunter with laser rifle
"Do I know you?"

Drong attacks the bounty hunter with the light sabre, causing 0 points of damage!

Yoda attacks the clone warrior with the light sabre, causing 0 points of damage!

The clone warrior attacks Drong with the clone blaster, causing 4 points of damage!

The bounty hunter attacks Yoda with the shock rifle, causing 7 points of damage!

* * *

>spar with yoda
(with the light sabre)
Yoda easilly evades your reach.
Yoda says "I cannot teach him. The boy has no patience."

Your experience points increases by 4.  
"hrrrm"

>yoda, follow me
"Yes, master jedi."
Yoda says "Ok, I will follow you."

>become yoda
I feel quite Yoda-ish now.

>maud, follow me
murmours "I feel compelled to … following .. yourself"Maud says "Ok, I will follow you."

>maud, go n
murmours "I feel compelled to … going .. the north"Maud goes north.

* * *

>spar with yoda
(with the light sabre)
Yoda side steps your clumsy maneuver.
Yoda says "Train yourself to let go of everything you fear to lose."

Your experience points increases by 2.  Yoda says "You're training is now complete!".  The force feels stronger in you now.  Drong will be you new padawan, Master Keav
"vrrrm"

>s
Arena
Sand, blood, iron. These festivals are normally held on hot days, but the sun has gone behind a cloud and fat drops of rain now and then spatter the arena floor.

A clone of the Empire is here.

One of Jabba's bounty hunters is here.

The clone warrior fixes on you, wielding a laser rifle and a clone blaster.
The bounty hunter faces you, menacing a shock rifle and a bounty blaster.

Drong arrives from the north.

>clone, kill bounty hunter with laser rifle
"Do I know you?"

Drong attacks the clone warrior with the light sabre, causing 0 points of damage!

The clone warrior attacks Drong with the laser rifle, causing 1 point of damage!

The bounty hunter attacks Drong with the bounty blaster, causing 3 points of damage!

"crackle"

* * *

>s
Darkness
It is pitch dark, and you can't see a thing.

The clone warrior turns to face you, wielding a laser rifle and a clone blaster.
The bounty hunter fixes on you, menacing a shock rifle and a bounty blaster.

Arena
Sand, blood, iron. These festivals are normally held on hot days, but the sun has gone behind a cloud and fat drops of rain now and then spatter the arena floor.

Keav is here.

A clone of the Empire is here.

One of Jabba's bounty hunters is here.

>clone, kill bounty hunter with sabre
There is no reply.

Keav attacks the bounty hunter with the light sabre, causing 2 points of damage!

The clone warrior attacks Keav with the clone blaster, causing 5 points of damage!

The bounty hunter attacks Keav with the shock rifle, causing 3 points of damage!

Drong arrives from the north.

>clone, kill bounty hunter with laser rifle
mutters "I need to … attacking it with .. the bounty hunter"
the clone warrior says "The bounty hunter is a friend. I would sooner fight you!"

The clone warrior is unable to do that.

Drong attacks the bounty hunter with the light sabre, causing 0 points of damage!

Keav attacks the clone warrior with the light sabre, causing 2 points of damage!

The clone warrior attacks Keav with the clone blaster, causing 2 points of damage!

The bounty hunter attacks you with the bounty blaster, causing 0 points of damage!

>n
Training Room
A place to practice jedi skills.  There is a door to the north and an exit to the south. There is a bench by the wall.

The groom, Maud is here.

Keav arrives from the south.

>maud, go s
murmours "I feel compelled to … going .. the south"
Maud goes south.

Drong arrives from the south.

* * *

>maud, follow me
murmours "I feel compelled to … following"Maud says "Ok, I will follow you."

>maud, go n
murmours "I feel compelled to … going"Maud goes north.

* * *

StarWords
An Interactive Fiction by Campbell Burgess
Release 1 / Serial number 130924 / Inform 7 build 6G60 (I6/v6.32 lib 6/12N) SD

Training Room
A place to practice jedi skills.  There is a door to the north and an exit to the south. There is a bench by the wall.

The groom, Maud is here.

Drong is here.

Yoda is here.

>test table
(Testing.)

>[1] open left drawer
You open the left drawer, revealing a light sabre.

>[2] open right drawer
You open the right drawer, revealing a battery.

>[3] get battery
(a battery)
Taken.

>[4] get sabre
Taken.

>[5] put battery in sabre
(a battery in the light sabre)
(first opening the light sabre)
(then closing the light sabre's battery compartment)

>[6] press button
The light sabre's blade now glows blue.

>test all
(Testing.)

>[1] test table
(Testing.)

>[2] open left drawer
That's already open.

>[3] open right drawer
That's already open.

>[4] get battery
That seems to be a part of the light sabre.

"vrrrm"
>[5] get sabre
You already have that.

"crackle"
>[6] put battery in sabre
(first opening the light sabre)
(first taking the light sabre's battery compartment)

That seems to be a part of the light sabre.

"wrrym"
>[7] press button
The light sabre's blue blade is extinguished.

>[8] test spar
(Testing.)

>[9] spar with yoda with sabre
The sabre is not on.

>[10] again
The sabre is not on.

>[11] again
The sabre is not on.

>[12] again
The sabre is not on.

>[13] again
The sabre is not on.

>[14] again
The sabre is not on.

>[15] again
The sabre is not on.

>[16] again
The sabre is not on.

>[17] test beyoda
(Testing.)

>[18] yoda, follow me
"I will not take instructions from one such as you!"

>[19] become yoda
You can only "become" a follower, and Yoda is NOT following you.