StarWords
An Interactive Fiction by Peter Burgess
Release 1 / Serial number 210503 / Inform 7 build 6M62 (I6/v6.33 lib 6/12N) SD

Training Room
A place to practice jedi skills.  There is a door to the north and an exit to the south. There is a bench by the wall.

Drong is here.

Yoda is here.

>yoda track me
That's not a verb I recognise.

>yoda, track me
Yoda says "Ok, I will follow yourself.
"

* * *

I beg your pardon?

>keav, go n
I will leave you, master jedi."
Keav goes north.

Drong goes north.

Keav arrives from the north.

* * *

>keav, stop following me
"Yes, master jedi."
Keav says "Ok, I will stop following you."

>keav, follow drong
"I will not take instructions from one such as you!"

>keav, follow me
"Yes, master jedi."
Keav says "Ok, I will follow you."

>keav, follow drong
"As you wish."
Keav says "Ok, I will follow Drong."

"wrrym"

>keav, follow me
"Yes, master jedi."
Keav says "Ok, I will follow you."

"crackle"

>keav, follow drong
"As you wish."
Keav says "Ok, I will follow Drong."

"hrrrm"

>keav, go n
"I will not take instructions from one such as you!"

>keav, follow me
"Yes, master jedi."
Keav says "Ok, I will follow you."

"snap"

>keav, go n
"As you wish."
Keav goes north.

Drong goes north.

Keav arrives from the north.

"vrrrm"

>keav, go n then stop following me
"As you wish."
Keav goes north.

Keav arrives from the north.

"hrrrm"
"Yes, master jedi."
Keav says "Ok, I will stop following you."

Drong arrives from the north.

>look
Training Room
A place to practice jedi skills.  There is a door to the north and an exit to the south. There is a bench by the wall.

Drong is here.

Keav is here.

>n
Darkness
It is pitch dark, and you can't see a thing.

"hrrrm"

>x sabre
It is pitch dark, and you can't see a thing.

"pop"

>s
Training Room
A place to practice jedi skills.  There is a door to the north and an exit to the south. There is a bench by the wall.

Drong is here.

Keav is here.

>x sabre
The green light sabre has a button at the hilt, and concealed compartment.

The green light sabre is currently switched on.

>inventory
You are carrying:
  a green light sabre

>press buton
You can't see any such thing.

>press button
The green light sabre's green blade is extinguished.

The blue light sabre is obviously going to go out quite soon.

>press button
The green light sabre's blade now glows green.

>x sabre
The green light sabre has a button at the hilt, and concealed compartment.

The green light sabre is currently switched on.

The blue light sabre loses power and switches off!

The blue light sabre's blue blade is extinguished.

The green light sabre is obviously going to go out quite soon.

>inventory
You are carrying:
  a green light sabre (providing light)

>take battery from green sabre
You can't see any such thing.

>take battery from green sabre's battery compartment
You can't see any such thing.

>take battery from green light sabre's battery compartment
You can't see any such thing.

>take battery from green light sabre's battery compartment
You can't see any such thing.

>open green light sabre
You open the green light sabre's battery compartment, revealing a battery.

The green light sabre loses power and switches off!

The green light sabre's green blade is extinguished.

>take battery from green light sabre's battery compartment
Which do you mean, the light sabre's battery compartment or a dead battery?

* * *

>keav, go n
"I will leave you, master jedi."
Keav goes north.

Drong goes north.

>relations
Follower relates various persons to one person:
  Drong  >=>  Keav
  Keav  >=>  yourself
Ally relates people to each other:
  You  <=>  Drong
  Keav  <=>  Drong
  Keav  <=>  yourself
  Keav  <=>  Keav
  The bounty hunter  <=>  the clone warrior
Enemy relates people to each other:
  The clone warrior  <=>  Drong
  The clone warrior  <=>  yourself
  The clone warrior  <=>  Keav
  The bounty hunter  <=>  Drong
  The bounty hunter  <=>  yourself
  The bounty hunter  <=>  Keav

* * *

>x sabre
The green light sabre has a button at the hilt, and concealed compartment.

The green light sabre is currently switched on.

"wrrym"

>inventory
You are carrying:
  a green light sabre

"hrrrm"

>drong, follow me
"Yes, master jedi."
Drong says "Ok, I will follow you."

>drong, go n
"Yes, master jedi."
Drong goes north.

Drong arrives from the north.

>drong, stop following me
"Yes, master jedi."
Drong says "Ok, I will stop following you."

>drong, go n
"Yes, master jedi."
Drong goes north.

"wrrym"

>yoda, follow drong
You can't see any such thing.

>n
Darkness
It is pitch dark, and you can't see a thing.

"pop"
closet
This is a dead end. You'll have to go back the way you came.

Keav is here.

Drong is here.

>keav, follow drong
"Yes, master jedi."
Keav says "Ok, I will follow Drong."

>become drong
You can only "become" a follower, and Drong is NOT following you.

"pop"

>drong, follow me
"Yes, master jedi."
Drong says "Ok, I will follow you."

>become drong
I feel quite Drong-ish now.

>keav, go s
"As you wish."
Keav goes south.

Keav arrives from the south.

* * *

>keave, stop following me
You seem to want to talk to someone, but I can't see whom.

>keav, stop following me
"Yes, master jedi."
Keav says "Ok, I will stop following you."

>relations
Follower relates various persons to one person:
  Drong  >=>  Keav
Ally relates people to each other:
  You  <=>  Drong
  Keav  <=>  Drong
  Keav  <=>  yourself
  Keav  <=>  Keav
  The bounty hunter  <=>  the clone warrior
Enemy relates people to each other:
  The clone warrior  <=>  Drong
  The clone warrior  <=>  yourself
  The clone warrior  <=>  Keav
  The bounty hunter  <=>  Drong
  The bounty hunter  <=>  yourself
  The bounty hunter  <=>  Keav

>keav, follow drong
"I will not take instructions from one such as you!"

>keav, become drong
That is just too existentially confusing.

>keav, attack drong
(with the blue light sabre)
"I will not take instructions from one such as you!"

>diagnose me
You have 95 out of a possible 100 hit points remaining.

* * *

>spar with yoda
(with the blue light sabre)
Yoda performs an elegant backflip to avoid your well aimed stroke.
Yoda says "The dark side clouds everything. Impossible to see the light, the future is."

Your experience points increases by 5.  Yoda says "You're training is now complete!".  The force feels stronger in you now.  Drong will be you new padawan, Master Keav

>yodaa, follow me
You seem to want to talk to someone, but I can't see whom.

>yoda, follow me
"Yes, master jedi."
Yoda says "Ok, I will follow you."

>yoda, go n
I will leave you, master jedi."

[** Programming error:  (object number 38)  has no property p69_follower to read **]

[** Programming error:  (object number 38)  has no property p69_follower to read **]

[** Programming error:  (object number 38)  has no property p69_follower to read **]

[** Programming error:  (object number 38)  has no property p69_follower to read **]

[** Programming error:  (object number 38)  has no property p69_follower to read **]
Yoda goes north.

Yoda arrives from the north.

"snap"

* * *

StarWords
An Interactive Fiction by Peter Burgess
Release 1 / Serial number 210503 / Inform 7 build 6M62 (I6/v6.33 lib 6/12N) SD

Training Room
A place to practice jedi skills.  There is a door to the north and an exit to the south. There is a bench by the wall.

Drong is here.

Yoda is here.

>yoda, track me
Yoda tracks yourself

>n
Darkness
It is pitch dark, and you can't see a thing.

>s
Training Room
A place to practice jedi skills.  There is a door to the north and an exit to the south. There is a bench by the wall.

Drong is here.

Yoda arrives from the north.

* * *

StarWords
An Interactive Fiction by Peter Burgess
Release 1 / Serial number 210503 / Inform 7 build 6M62 (I6/v6.33 lib 6/12N) SD

Training Room
A place to practice jedi skills.  There is a door to the north and an exit to the south. There is a bench by the wall.

Drong is here.

Yoda is here.

>drong, go n
Drong says "I do not come and go at your bidding!"

* * *

StarWords
An Interactive Fiction by Peter Burgess
Release 1 / Serial number 210503 / Inform 7 build 6M62 (I6/v6.33 lib 6/12N) SD

Training Room
A place to practice jedi skills.  There is a door to the north and an exit to the south. There is a bench by the wall.

Drong is here.

Yoda is here.

>drong, spar with me
(with the blue light sabre)
Drong spars with yourself with the blue light sabre
Drong's experience points increases by -1.

>yoda, spar with me
(with the green light sabre)
Yoda spars with yourself with the green light sabre

>yoda, spar with drong
(with the green light sabre)
Yoda spars with Drong with the green light sabre

>drong, spar with yoda
(with the blue light sabre)
Drong spars with Yoda with the blue light sabre
Drong's experience points increases by 4.

>drong, spar with yoda
(with the blue light sabre)
Drong spars with Yoda with the blue light sabre
Drong's experience points increases by 6.

>drong, spar with yoda
(with the blue light sabre)
Drong spars with Yoda with the blue light sabre
Drong's experience points increases by 4.

>drong, spar with yoda
(with the blue light sabre)
Drong spars with Yoda with the blue light sabre

* * *

StarWords
An Interactive Fiction by Peter Burgess
Release 1 / Serial number 210503 / Inform 7 build 6M62 (I6/v6.33 lib 6/12N) SD

Training Room
A place to practice jedi skills.  There is a door to the north and an exit to the south. There is a bench by the wall.

Drong is here.

Yoda is here.

>drong, spar with yoda
(with the blue light sabre)
Drong says "I would prefer to spar with you!"

Drong spars with Yoda with the blue light sabre
Drong's experience points increases by 1.

>drong, spar with yoda
(with the blue light sabre)
Drong says "I would prefer to spar with you!"

Drong spars with Yoda with the blue light sabre
Drong's experience points increases by 7.

>drong, spar with yoda
(with the blue light sabre)
Drong says "I would prefer to spar with you!"

Drong spars with Yoda with the blue light sabre
Drong's experience points increases by 6.

>drong, spar with yoda
(with the blue light sabre)
Drong says "I would prefer to spar with you!"

Drong spars with Yoda with the blue light sabre

>drong, spar with yoda
(with the blue light sabre)
Drong says "I would prefer to spar with you!"

Drong spars with Yoda with the blue light sabre

>drong, spar with me
(with the blue light sabre)
Drong says "How about you spar with me!"

Drong spars with yourself with the blue light sabre

* * *

>drong, spar with yoda
(with the blue light sabre)
Drong says "I would prefer to spar with you!"

Drong spars with Yoda with the blue light sabre
Drong's experience points increases by 1.

>yoda, spar with drong
(with the green light sabre)
Yoda says "I would prefer to spar with you!"

Yoda spars Drong with the green light sabre

* * *

StarWords
An Interactive Fiction by Peter Burgess
Release 1 / Serial number 210503 / Inform 7 build 6M62 (I6/v6.33 lib 6/12N) SD

Training Room
A place to practice jedi skills.  There is a door to the north and an exit to the south. There is a bench by the wall.

Drong is here.

Yoda is here.

>drong, go s
"I do not come and go at your bidding!"

* * *

StarWords
An Interactive Fiction by Peter Burgess
Release 1 / Serial number 210503 / Inform 7 build 6M62 (I6/v6.33 lib 6/12N) SD

Training Room
A place to practice jedi skills.  There is a door to the north and an exit to the south. There is a bench by the wall.

Drong is here.

Yoda is here.

>Yoda, follow me
Yoda says "Ok, I will follow yourself."

>Yoda, follow drong
Yoda says "Ok, I will follow Drong."

>relations
Follower relates various persons to one person:
  Yoda  >=>  Drong
Ally relates people to each other:
  Drong  <=>  yourself
  Yoda  <=>  yourself
  Yoda  <=>  Drong
  The bounty hunter  <=>  the clone warrior
Enemy relates people to each other:
  The clone warrior  <=>  yourself
  The clone warrior  <=>  Drong
  The clone warrior  <=>  Yoda
  The bounty hunter  <=>  yourself
  The bounty hunter  <=>  Drong
  The bounty hunter  <=>  Yoda

>drong, follow me
Drong says "Ok, I will follow yourself."

* * *

>relations
Follower relates various persons to one person:
  Drong  >=>  yourself
  Yoda  >=>  Drong
Ally relates people to each other:
  Drong  <=>  yourself
  Yoda  <=>  yourself
  Yoda  <=>  Drong
  The bounty hunter  <=>  the clone warrior
Enemy relates people to each other:
  The clone warrior  <=>  yourself
  The clone warrior  <=>  Drong
  The clone warrior  <=>  Yoda
  The bounty hunter  <=>  yourself
  The bounty hunter  <=>  Drong
  The bounty hunter  <=>  Yoda

>test table
(Testing.)

>[1] open left drawer
You open the left drawer, revealing a light sabre.

>[2] open right drawer
You open the right drawer, revealing a D battery.

>[3] get d battery
Taken.

>[4] get sabre
Taken.

>[5] put battery in sabre
(the D battery in the light sabre)
(first opening the light sabre)
(then closing the light sabre's battery compartment)

* * *

>press button
It is now on.

>s
Arena
Sand, blood, iron. These festivals are normally held on hot days, but the sun has gone behind a cloud and fat drops of rain now and then spatter the arena floor.

A clone warrior faces you, wielding a laser rifle and a clone blaster.

A bounty hunter circles you, pointing a shock rifle and a bounty blaster.

The clone warrior attacks you with the laser rifle, causing 4 points of damage!

The bounty hunter attacks you with the shock rifle, causing 3 points of damage!

Drong arrives from the north.

>hit clone with rifle
Which do you mean, the laser rifle or the shock rifle?

>hit clone with sabre
(the clone warrior with the light sabre)
You missed the clone warrior
Drong attacks the bounty hunter with the blue light sabre, causing 3 points of damage!

The clone warrior attacks Drong with the clone blaster, causing 0 points of damage!

The bounty hunter attacks Drong with the bounty blaster, causing 2 points of damage!

"vrrrm"

>clone, attack drong with blaster
(the clone blaster)
The clone warrior attacks Drong with the clone blaster, causing 4 points of damage!

Drong attacks the clone warrior with the blue light sabre, causing 2 points of damage!

The clone warrior attacks you with the laser rifle, causing 5 points of damage!

The bounty hunter attacks Drong with the shock rifle, causing 7 points of damage!

>clone, attack hunter with blaster
(the clone blaster)
the clone warrior says "The bounty hunter is a friend. I would sooner fight you!"

The clone warrior is unable to do that.

Drong attacks the bounty hunter with the blue light sabre, causing 4 points of damage!

The clone warrior attacks Drong with the laser rifle, causing 1 point of damage!

The bounty hunter attacks Drong with the bounty blaster, causing 0 points of damage!

* * *

StarWords
An Interactive Fiction by Peter Burgess
Release 1 / Serial number 210503 / Inform 7 build 6M62 (I6/v6.33 lib 6/12N) SD

Training Room
A place to practice jedi skills.  There is a door to the north and an exit to the south. There is a bench by the wall.

Drong is here.

Yoda is here.

>test table
(Testing.)

>[1] open left drawer
You open the left drawer, revealing a light sabre.

>[2] open right drawer
You open the right drawer, revealing a battery.

>[3] get battery
(a battery)
Taken.

>[4] get sabre
Taken.

>[5] put battery in sabre
(a battery in the light sabre)
(first opening the light sabre)
(then closing the light sabre's battery compartment)

>[6] press button
The blue light sabre's blade now glows blue.

>spar with yoda
(with the blue light sabre)
Yoda switches the green light sabre on.

Yoda side steps your clumsy maneuver.
Yoda says "Ohhh. Great warrior. Wars not make one great."

Your experience points increases by 10.  
"wrrym"

>x green sabre
You can't see any such thing.

>test spq
>--> The following tests are available:
'test table'
'test me'
'test first'
'test second'
'test sabre'
'test spar'
'test beyoda'
'test all'

>test spa
>--> The following tests are available:
'test table'
'test me'
'test first'
'test second'
'test sabre'
'test spar'
'test beyoda'
'test all'

>test spa
>--> The following tests are available:
'test table'
'test me'
'test first'
'test second'
'test sabre'
'test spar'
'test beyoda'
'test all'

>test spar
(Testing.)

>[1] spar with yoda with sabre
Yoda performs an elegant backflip to avoid your well aimed stroke.
Yoda says "In a dark place we find ourselves, and a little more knowledge lights our way."

Your experience points increases by 1.  

>[2] again
Yoda easilly evades your reach.
Yoda says "Fear is the path to the dark side. Fear leads to anger. Anger leads to hate. Hate leads to suffering."

Your experience points increases by 7.  

>[3] again
Yoda performs an elegant backflip to avoid your well aimed stroke.
Yoda says "A Jedi must have the deepest commitment, the most serious mind. "

Your experience points increases by 4.  
"crackle"
>[4] again
Yoda side steps your clumsy maneuver.
Yoda says "You will know ...the good from the bad… when you are calm, at peace. Passive. A Jedi uses the Force for knowledge and defense, never for attack."

Your experience points increases by 6.  
"vrrrm"
>[5] again
Yoda strikes like a viper while seeming to hover outside your range.
Yoda says "Always in motion is the future."

Your experience points increases by 5.  

>[6] again
Yoda side steps your clumsy maneuver.
Yoda says "And well you should not. For my ally in the Force. And a powerful ally it is. Life creates it, makes it grow. It's energy surrounds us and binds us. Luminous beings are we...(Yoda pinches Luke's shoulder)...not this crude matter. (a sweeping gesture) You must feel the Force around you. (gesturing) Here, between you...me...the tree...the rock...everywhere! Yes, even between this land and that ship!"

Your experience points increases by 2.  
"snap"
>[7] again
Yoda easilly evades your reach.
Yoda says "When you look at the dark side, careful you must be. For the dark side looks back."

Your experience points increases by 1.  

>[8] again
Yoda side steps your clumsy maneuver.
Yoda says "Through the Force, things you will see. Other places. The future...the past. Old friends long gone. "

Your experience points increases by 1.  

>[9] again
Yoda easilly evades your reach.
Yoda says "A Jedi must have the deepest commitment, the most serious mind. "

Your experience points increases by 0.  

>[10] again
Yoda strikes like a viper while seeming to hover outside your range.
Yoda says "Already know you that which you need."

Your experience points increases by 3.  Yoda says "You're training is now complete!".  The force feels stronger in you now.  Drong will be you new padawan, Master Keav
"pop"
>[11] again
Yoda easilly evades your reach.
Yoda says "In a dark place we find ourselves, and a little more knowledge lights our way."

>[12] again
Yoda performs an elegant backflip to avoid your well aimed stroke.
Yoda says "Fear is the path to the dark side. Fear leads to anger. Anger leads to hate. Hate leads to suffering."

>spar with yoda
(with the blue light sabre)
Yoda easilly evades your reach.
Yoda says "Train yourself to let go of everything you fear to lose."

>yoda, follow me
Yoda says "Yes, master jedi."
Yoda says "Ok, I will follow you."

>become yoda
I feel quite Yoda-ish now.

>inventory
You are carrying:
  a green light sabre (providing light)

* * *

StarWords
An Interactive Fiction by Peter Burgess
Release 1 / Serial number 210503 / Inform 7 build 6M62 (I6/v6.33 lib 6/12N) SD

Training Room
A place to practice jedi skills.  There is a door to the north and an exit to the south. There is a bench by the wall.

Drong is here.

Yoda is here.

>yoda, fight me
(with the green light sabre)
Yoda  says "I will not fight you, my friend.

Yoda is unable to do that.

>test table
(Testing.)

>[1] open left drawer
You open the left drawer, revealing a light sabre.

>[2] open right drawer
You open the right drawer, revealing a D battery.

>[3] get d battery
Taken.

>[4] get sabre
Taken.

>[5] put battery in sabre
(the D battery in the light sabre)
(first opening the light sabre)
(then closing the light sabre's battery compartment)

* * *

>press button
It is now on.

>yoda, fight me
(with the green light sabre)
Yoda  says "I will not fight you, my friend.

Yoda is unable to do that.

>fight yoda
(with the light sabre)
Ooh I think this is a mistake.
You attack Yoda with the light sabre, causing 2 points of damage!

"crackle"

>yoda, fight me
(with the green light sabre)
Yoda attacks you with the green light sabre, causing 5 points of damage!

>yoda, fight me
(with the green light sabre)
Yoda attacks you with the green light sabre, causing 7 points of damage!

"pop"

>fight yoda
(with the light sabre)
If you are very lucky you'll live long enough to regret this.
You attack Yoda with the light sabre, causing 2 points of damage!

Yoda attacks you with the green light sabre, causing 8 points of damage!

>spar with yoda
(with the light sabre)
Yoda is going to play for keeps.

Yoda attacks you with the green light sabre, causing 4 points of damage!

"wrrym"

>yoda, spar with me
(with the green light sabre)
Yoda says "How about you spar with me!"

yourself is going to play for keeps.

Yoda is unable to do that.

Yoda attacks you with the green light sabre, causing 5 points of damage!

"crackle"

>s
Arena
Sand, blood, iron. These festivals are normally held on hot days, but the sun has gone behind a cloud and fat drops of rain now and then spatter the arena floor.

A clone warrior faces you, wielding a laser rifle and a clone blaster.

A bounty hunter circles you, pointing a shock rifle and a bounty blaster.

The clone warrior attacks you with the clone blaster, causing 0 points of damage!

The bounty hunter attacks you with the shock rifle, finishing you off!

    *** The End ***

In that game you scored 0 out of a possible 0, in 15 turns.

Would you like to RESTART, RESTORE a saved game, QUIT or UNDO the last command?

* * *

StarWords
An Interactive Fiction by Peter Burgess
Release 1 / Serial number 210503 / Inform 7 build 6M62 (I6/v6.33 lib 6/12N) SD

Training Room
A place to practice jedi skills.  There is a door to the north and an exit to the south. There is a bench by the wall.

Drong is here.

Yoda is here.

>yoda, fight yoda
(with the green light sabre)
Yoda  says "Don't be absurd."

Yoda is unable to do that.

* * *

StarWords
An Interactive Fiction by Peter Burgess
Release 1 / Serial number 210503 / Inform 7 build 6M62 (I6/v6.33 lib 6/12N) SD

Training Room
A place to practice jedi skills.  There is a door to the north and an exit to the south. There is a bench by the wall.

Drong is here.

Yoda is here.

>be yoda
That's not a verb I recognise.

>hi yoda
That's not a verb I recognise.

>look yoda
Yoda is respected as one of the most wise and powerful Jedi Masters in the history of the galaxy. Yoda is a master of the Force and Light Sabre combat. Yoda has served as the Grand Master of the Jedi High Council for over 700 years.  Yoda is carrying nothing.

>go bench
That's not something you can enter.

>look bench
It is an ordinary bench with two drawers, left and right

>open left drawer
You open the left drawer, revealing a light sabre.

>get light
(the light sabre)
Taken.

>open right drawer
You open the right drawer, revealing a battery.

>get battery
(a battery)
Taken.

>put battery in light
(a battery in the light sabre's battery compartment)
(first opening the light sabre's battery compartment)
(then closing the light sabre's battery compartment)

>look light
You can't use multiple objects with that verb.

>look light sabre
The light sabre has a button at the hilt, and concealed compartment.

The light sabre is currently switched off.

>turn on light
The blue light sabre's blade now glows blue.

>wave light
You can't use multiple objects with that verb.

>attack yoda with light
(the blue light sabre)
Ooh I think this is a mistake.
You missed Yoda
"hrrrm"

>attack yoda with light
(the blue light sabre)
If you are very lucky you'll live long enough to regret this.
You missed Yoda
Yoda turns to face you, menacing a green light sabre.

>attack yoda with light
(the blue light sabre)
You attack Yoda with the blue light sabre, causing 2 points of damage!
Looks like Yoda is taking this personally.

Yoda attacks you with the green light sabre, causing 0 points of damage!

"wrrym"

>attack yoda with light
(the blue light sabre)
You missed Yoda
Yoda attacks you with the green light sabre, causing 0 points of damage!

"crackle"

>attack yoda with light
(the blue light sabre)
You attack Yoda with the blue light sabre, causing 4 points of damage!

Yoda attacks you with the green light sabre, causing 0 points of damage!

"hrrrm"

>attack yoda with light
(the blue light sabre)
You missed Yoda
Yoda attacks you with the green light sabre, causing 0 points of damage!

>attack yoda with light
(the blue light sabre)
You attack Yoda with the blue light sabre, causing 1 point of damage!

Yoda attacks you with the green light sabre, causing 0 points of damage!

>attack yoda with light
(the blue light sabre)
You attack Yoda with the blue light sabre, causing 2 points of damage!

Yoda attacks you with the green light sabre, causing 0 points of damage!

>attack yoda with light
(the blue light sabre)
You attack Yoda with the blue light sabre, causing 5 points of damage!

Yoda attacks you with the green light sabre, causing 0 points of damage!

>attack yoda with light
(the blue light sabre)
You attack Yoda with the blue light sabre, causing 1 point of damage!

Yoda attacks you with the green light sabre, causing 0 points of damage!

"hrrrm"

>attack yoda with light
(the blue light sabre)
You attack Yoda with the blue light sabre, causing 4 points of damage!

Yoda attacks you with the green light sabre, causing 0 points of damage!

>attack yoda with light
(the blue light sabre)
You attack Yoda with the blue light sabre, causing 5 points of damage!

Yoda attacks you with the green light sabre, causing 0 points of damage!

"crackle"

>attack yoda with light
(the blue light sabre)
You attack Yoda with the blue light sabre, causing 2 points of damage!

Yoda attacks you with the green light sabre, causing 0 points of damage!

>inv
You are carrying:
  a blue light sabre (providing light)

Yoda attacks you with the green light sabre, causing 0 points of damage!

>inv
You are carrying:
  a blue light sabre (providing light)

Yoda attacks you with the green light sabre, causing 0 points of damage!

>inv
You are carrying:
  a blue light sabre (providing light)

Yoda attacks you with the green light sabre, causing 0 points of damage!

"wrrym"

>inv
You are carrying:
  a blue light sabre (providing light)

Yoda attacks you with the green light sabre, causing 0 points of damage!

"pop"

>attack
Whom do you want to attack?

>attack yoda
(with the blue light sabre)
You attack Yoda with the blue light sabre, causing 1 point of damage!

Yoda attacks you with the green light sabre, causing 0 points of damage!

>attack yoda
(with the blue light sabre)
You missed Yoda
Yoda attacks you with the green light sabre, causing 0 points of damage!

"snap"

>attack yoda
(with the blue light sabre)
You attack Yoda with the blue light sabre, causing 4 points of damage!

Yoda attacks you with the green light sabre, causing 0 points of damage!

>attack yoda
(with the blue light sabre)
You attack Yoda with the blue light sabre, causing 3 points of damage!

Yoda attacks you with the green light sabre, causing 0 points of damage!

"snap"

>attack yoda
(with the blue light sabre)
You attack Yoda with the blue light sabre, causing 2 points of damage!

Yoda attacks you with the green light sabre, causing 0 points of damage!

>attack yoda
(with the blue light sabre)
You attack Yoda with the blue light sabre, causing 3 points of damage!

Yoda attacks you with the green light sabre, causing 0 points of damage!

>attack yoda
(with the blue light sabre)
You attack Yoda with the blue light sabre, causing 4 points of damage!

Yoda attacks you with the green light sabre, causing 0 points of damage!

>attack yoda
(with the blue light sabre)
You attack Yoda with the blue light sabre, causing 3 points of damage!

Yoda attacks you with the green light sabre, causing 0 points of damage!

>attack yoda
(with the blue light sabre)
You attack Yoda with the blue light sabre, causing 5 points of damage!

Yoda attacks you with the green light sabre, causing 0 points of damage!

"snap"

>attack yoda
(with the blue light sabre)
You missed Yoda
Yoda attacks you with the green light sabre, causing 0 points of damage!

>attack yoda
(with the blue light sabre)
You attack Yoda with the blue light sabre, causing 4 points of damage!

Yoda attacks you with the green light sabre, causing 0 points of damage!

>attack yoda
(with the blue light sabre)
You attack Yoda with the blue light sabre, causing 5 points of damage!

Yoda attacks you with the green light sabre, causing 0 points of damage!

>attack yoda
(with the blue light sabre)
You attack Yoda with the blue light sabre, causing 4 points of damage!

Yoda attacks you with the green light sabre, causing 0 points of damage!

The blue light sabre is obviously going to go out quite soon.

"snap"

>attack yoda
(with the blue light sabre)
You missed Yoda
Yoda attacks you with the green light sabre, causing 0 points of damage!

>attack yoda
(with the blue light sabre)
You missed Yoda
Yoda attacks you with the green light sabre, causing 0 points of damage!

The blue light sabre loses power and switches off!
The blue light sabre's blue blade is extinguished.

>attack yoda
(with the light sabre)
The sabre is not on.

Yoda attacks you with the light sabre, causing 0 points of damage!

>become yoda
You can only "become" an ally, and Yoda is NOT an ally of yours.

Yoda attacks you with the light sabre, causing 0 points of damage!

>look
Training Room
A place to practice jedi skills.  There is a door to the north and an exit to the south. There is a bench by the wall.

Drong is here.

Yoda is here.

Yoda attacks you with the light sabre, causing 0 points of damage!

>become drong
You can only "become" a follower, and Drong is NOT following you.

Yoda attacks you with the light sabre, causing 0 points of damage!

>diagnose me
You have 30 out of a possible 35 hit points remaining.

Yoda attacks you with the light sabre, causing 0 points of damage!

>diagnose yoda
Yoda has 31 out of a possible 100 hit points remaining.

Yoda attacks you with the light sabre, causing 0 points of damage!

>look at yoda
Yoda is respected as one of the most wise and powerful Jedi Masters in the history of the galaxy. Yoda is a master of the Force and Light Sabre combat. Yoda has served as the Grand Master of the Jedi High Council for over 700 years.  Yoda is carrying nothing.

Yoda attacks you with the light sabre, causing 0 points of damage!

* * *

StarWords
An Interactive Fiction by Peter Burgess
Release 1 / Serial number 210503 / Inform 7 build 6M62 (I6/v6.33 lib 6/12N) SD

Training Room
A place to practice jedi skills.  There is a door to the north and an exit to the south. There is a bench by the wall.

Drong is here.

Yoda is here.

>get light
You can't see any such thing.

>go bench
That's not something you can enter.

* * *

>get light
(the light sabre)
Taken.

>open right draw
I only understood you as far as wanting to open the right drawer.

>open right drawer
You open the right drawer, revealing a battery.

>get batter
You can't see any such thing.

>get battery
(a battery)
Taken.

* * *

>put battery in light
(a battery in the light sabre's battery compartment)
(first opening the light sabre's battery compartment)
(then closing the light sabre's battery compartment)

>light sabre
This dangerous act would achieve little.

>turn on sabre
The blue light sabre's blade now glows blue.

>attack yoda with sabre
Ooh I think this is a mistake.
You attack Yoda with the blue light sabre, causing 4 points of damage!

"hrrrm"

>attack yoda with sabre
If you are very lucky you'll live long enough to regret this.
You attack Yoda with the blue light sabre, causing 2 points of damage!

Yoda turns to face you, pointing a green light sabre.

"pop"

>attack yoda with sabre
You missed Yoda
Yoda attacks you with the green light sabre, causing 4 points of damage!

>attack yoda with sabre
You attack Yoda with the blue light sabre, causing 4 points of damage!

Yoda attacks you with the green light sabre, causing 0 points of damage!

"crackle"

>attack yoda with sabre
You attack Yoda with the blue light sabre, causing 4 points of damage!

Yoda attacks you with the green light sabre, causing 10 points of damage!

>attack yoda with sabre
You attack Yoda with the blue light sabre, causing 1 point of damage!
Looks like Yoda is taking this personally.

Yoda attacks you with the green light sabre, causing 8 points of damage!

>attack yoda with sabre
You attack Yoda with the blue light sabre, causing 1 point of damage!

Yoda attacks you with the green light sabre, causing 4 points of damage!

>attack yoda with sabre
You attack Yoda with the blue light sabre, causing 1 point of damage!

Yoda attacks you with the green light sabre, finishing you off!

    *** The End ***

Would you like to RESTART, RESTORE a saved game, QUIT or UNDO the last command?