StarWords
An Interactive Fiction by Campbell Burgess
Release 1 / Serial number 130920 / Inform 7 build 6G60 (I6/v6.32 lib 6/12N) SD

Training Room
A place to practice jedi skills.  There is a door to the north and an exit to the south. There is a bench by the wall.

Drong is here.

Yoda is here.

>yoda track me
That's not a verb I recognise.

* * *

StarWords
An Interactive Fiction by Campbell Burgess
Release 1 / Serial number 130920 / Inform 7 build 6G60 (I6/v6.32 lib 6/12N) SD

Training Room
A place to practice jedi skills.  There is a door to the north and an exit to the south. There is a bench by the wall.

Drong is here.

Yoda is here.

>Yoda, follow me
Yoda says "Ok, I will follow yourself."

* * *

StarWords
An Interactive Fiction by Campbell Burgess
Release 1 / Serial number 130920 / Inform 7 build 6G60 (I6/v6.32 lib 6/12N) SD

Training Room
A place to practice jedi skills.  There is a door to the north and an exit to the south. There is a bench by the wall.

Drong is here.

Yoda is here.

>yoda, fight me
(with the green light sabre)
Yoda  says "I will not fight you, my friend.

Yoda is unable to do that.

* * *

StarWords
An Interactive Fiction by Campbell Burgess
Release 1 / Serial number 130920 / Inform 7 build 6G60 (I6/v6.32 lib 6/12N) SD

Training Room
A place to practice jedi skills.  There is a door to the north and an exit to the south. There is a bench by the wall.

Drong is here.

Yoda is here.

>become yoda
I feel quite Yoda-ish now.

>inventory
You are carrying:
  a battery
  a light sabre

>put battery in sabre
(a battery in the light sabre)
(first opening the light sabre)
(then closing the light sabre's battery compartment)

>press button
It's blade is glowing green.

It is now on.

"hrrrm"

>become Donrg
You can't see any such thing.

>become drong
I feel quite Drong-ish now.

>put battery in sabre
(a battery in the light sabre)
(first opening the light sabre)
(then closing the light sabre's battery compartment)

>press button
It's blade is glowing purple.

It is now on.

* * *

StarWords
An Interactive Fiction by Campbell Burgess
Release 1 / Serial number 130920 / Inform 7 build 6G60 (I6/v6.32 lib 6/12N) SD

Training Room
A place to practice jedi skills.  There is a door to the north and an exit to the south. There is a bench by the wall.

Drong is here.

Yoda is here.

>yoda, track me
Yoda tracks yourself

* * *

StarWords
An Interactive Fiction by Campbell Burgess
Release 1 / Serial number 130920 / Inform 7 build 6G60 (I6/v6.32 lib 6/12N) SD

Training Room
A place to practice jedi skills.  There is a door to the north and an exit to the south. There is a bench by the wall.

Drong is here.

Yoda is here.

>drong, spar with me
(with the blue light sabre)
Drong spars with yourself with the blue light sabre
Drong's experience points increases by -1.

* * *

StarWords
An Interactive Fiction by Campbell Burgess
Release 1 / Serial number 130920 / Inform 7 build 6G60 (I6/v6.32 lib 6/12N) SD

Training Room
A place to practice jedi skills.  There is a door to the north and an exit to the south. There is a bench by the wall.

Drong is here.

Yoda is here.

>yoda, follow drong
There is no reply.

>yoda, follow me
There is no reply.

>yoda, track drong
Yoda says "Ok, I will follow Drong."

* * *

StarWords
An Interactive Fiction by Campbell Burgess
Release 1 / Serial number 130920 / Inform 7 build 6G60 (I6/v6.32 lib 6/12N) SD

Training Room
A place to practice jedi skills.  There is a door to the north and an exit to the south. There is a bench by the wall.

Drong is here.

Yoda is here.

>drong, spar with yoda
(with the blue light sabre)
Drong says "I would prefer to spar with you!"

Drong spars with Yoda with the blue light sabre
Drong's experience points increases by 1.

* * *

StarWords
An Interactive Fiction by Campbell Burgess
Release 1 / Serial number 130920 / Inform 7 build 6G60 (I6/v6.32 lib 6/12N) SD

Training Room
A place to practice jedi skills.  There is a door to the north and an exit to the south. There is a bench by the wall.

Drong is here.

Yoda is here.

>relations
Ally relates people to each other:
  Yoda  <=>  Drong
  You  <=>  Drong
  You  <=>  Yoda
  You  <=>  yourself
  The bounty hunter  <=>  the clone warrior
Enemy relates people to each other:
  The clone warrior  <=>  Drong
  The clone warrior  <=>  Yoda
  The clone warrior  <=>  yourself
  The bounty hunter  <=>  Drong
  The bounty hunter  <=>  Yoda
  The bounty hunter  <=>  yourself

>test table
(Testing.)

>[1] open left drawer
You open the left drawer, revealing a light sabre.

>[2] open right drawer
You open the right drawer, revealing a battery.

>[3] get battery
(a battery)
Taken.

>[4] get sabre
Taken.

>[5] put battery in sabre
(a battery in the light sabre)
(first opening the light sabre)
(then closing the light sabre's battery compartment)

>[6] press button
The light sabre's blade now glows blue.

"snap"

>test spar
(Testing.)

>[1] spar with yoda with sabre
Yoda performs an elegant backflip to avoid your well aimed stroke.
Yoda says "Yes, a Jedi's strength flows from the Force. But beware of the dark side. Anger, fear, aggression; the dark side of the Force are they. Easily they flow, quick to join you in a fight. If once you start down the dark path, forever will it dominate your destiny, consume you it will, as it did Obi-Wan's apprentice."

Your experience points increases by 9.  

>[2] again
Yoda strikes like a viper while seeming to hover outside your range.
Yoda says "Yes, a Jedi's strength flows from the Force. But beware of the dark side. Anger, fear, aggression; the dark side of the Force are they. Easily they flow, quick to join you in a fight. If once you start down the dark path, forever will it dominate your destiny, consume you it will, as it did Obi-Wan's apprentice."

Your experience points increases by 6.  

>[3] again
Yoda easilly evades your reach.
Yoda says "A Jedi must have the deepest commitment, the most serious mind. "

Your experience points increases by 3.  
"vrrrm"
>[4] again
Yoda performs an elegant backflip to avoid your well aimed stroke.
Yoda says "Once you start down the dark path, forever will it dominate your destiny, consume you it will."

Your experience points increases by 0.  
"crackle"
>[5] again
Yoda side steps your clumsy maneuver.
Yoda says "Named must your fear be before banish it you can."

Your experience points increases by 2.  

>[6] s

Arena
Sand, blood, iron. These festivals are normally held on hot days, but the sun has gone behind a cloud and fat drops of rain now and then spatter the arena floor.

A clone warrior faces you, wielding a laser rifle and a clone blaster.

A bounty hunter circles you, pointing a shock rifle and a bounty blaster.

The clone warrior attacks you with the clone blaster, causing 4 points of damage!

The bounty hunter attacks you with the bounty blaster, causing 1 point of damage!

>n
Training Room
A place to practice jedi skills.  There is a door to the north and an exit to the south. There is a bench by the wall.

Drong is here.

Yoda is here.

>spar with yoda
(with the light sabre)
Yoda easilly evades your reach.
Yoda says "Try not. Do or do not, there is no try."

Your experience points increases by 2.

>spar with yoda
(with the light sabre)
Yoda performs an elegant backflip to avoid your well aimed stroke.
Yoda says "When you look at the dark side, careful you must be. For the dark side looks back."

Your experience points increases by 6.  
"vrrrm"

>spar with yoda
(with the light sabre)
Yoda easilly evades your reach.
Yoda says "You must unlearn what you have learned."

Your experience points increases by 7.  
"crackle"

>spar with yoda
(with the light sabre)
Yoda side steps your clumsy maneuver.
Yoda says "Once you start down the dark path, forever will it dominate your destiny, consume you it will."

Your experience points increases by 0.

>spar with yoda
(with the light sabre)
Yoda strikes like a viper while seeming to hover outside your range.
Yoda says "Ohhh. Great warrior. Wars not make one great."

Your experience points increases by 2.

>spar with yoda
(with the light sabre)
Yoda performs an elegant backflip to avoid your well aimed stroke.
Yoda says "And well you should not. For my ally in the Force. And a powerful ally it is. Life creates it, makes it grow. It's energy surrounds us and binds us. Luminous beings are we...(Yoda pinches Luke's shoulder)...not this crude matter. (a sweeping gesture) You must feel the Force around you. (gesturing) Here, between you...me...the tree...the rock...everywhere! Yes, even between this land and that ship!"

Your experience points increases by 2.  
"crackle"

>spar with yoda
(with the light sabre)
Yoda side steps your clumsy maneuver.
Yoda says "When you look at the dark side, careful you must be. For the dark side looks back."

Your experience points increases by 6.  Yoda says "You're training is now complete!".  The force feels stronger in you now.  Drong will be you new padawan, Master Keav

>yoda, follow me
"Okay."
Yoda says "Ok, I will follow yourself."

>s
Arena
Sand, blood, iron. These festivals are normally held on hot days, but the sun has gone behind a cloud and fat drops of rain now and then spatter the arena floor.

A clone warrior faces you, wielding a laser rifle and a clone blaster.

A bounty hunter circles you, pointing a shock rifle and a bounty blaster.

The clone warrior attacks you with the laser rifle, causing 5 points of damage!

The bounty hunter attacks you with the bounty blaster, causing 0 points of damage!

Drong arrives from the north.

Yoda arrives from the north.

>yoda, kill clonw
There is no reply.

Yoda attacks the clone warrior with the light sabre, causing 2 points of damage!

Drong attacks the clone warrior with the light sabre, causing 4 points of damage!

The clone warrior attacks you with the laser rifle, causing 4 points of damage!

The bounty hunter attacks Yoda with the bounty blaster, causing 0 points of damage!

>yoda, kill clone
What do you want Yoda to kill the clone warrior with?

>yoda, kill clone sabre
There is no reply.

Yoda attacks the bounty hunter with the light sabre, causing 5 points of damage!

Drong attacks the bounty hunter with the light sabre, causing 5 points of damage!

The clone warrior attacks Yoda with the clone blaster, causing 3 points of damage!

The bounty hunter attacks Drong with the shock rifle, causing 4 points of damage!

>yoda, kill clone with sabre
(the clone warrior with the light sabre)
"Okay."
Yoda attacks the clone warrior with the light sabre, causing 5 points of damage!

Yoda attacks the clone warrior with the light sabre, causing 9 points of damage!

Drong attacks the bounty hunter with the light sabre, causing 1 point of damage!

The clone warrior attacks Yoda with the clone blaster, causing 3 points of damage!

The bounty hunter attacks you with the shock rifle, causing 3 points of damage!

>yoda, kill clone with sabre
(the clone warrior with the light sabre)
"Okay."
Yoda attacked the clone warrior with the light sabre, killing the clone warrior!

Yoda attacks the bounty hunter with the light sabre, causing 8 points of damage!

Drong attacked the bounty hunter with the light sabre, killing the bounty hunter!

>yoda, kill clone with sabre
There is no reply.

>kill hunter
You can't see any such thing.

>look
Arena
Sand, blood, iron. These festivals are normally held on hot days, but the sun has gone behind a cloud and fat drops of rain now and then spatter the arena floor.

Yoda is here.

Drong is here.

You can also see a bounty blaster, a shock rifle, a clone blaster and a laser rifle here.

"vrrrm"

>killhunter
That's not a verb I recognise.

>kill hunter
You can't see any such thing.

>kill bounty hunter
You can only do that to something animate.

>kill bounty hunter with sabre
You can only do that to something animate.

>get all
bounty blaster: Taken.
shock rifle: Taken.
clone blaster: Taken.
laser rifle: Taken.

* * *

StarWords
An Interactive Fiction by Campbell Burgess
Release 1 / Serial number 130920 / Inform 7 build 6G60 (I6/v6.32 lib 6/12N) SD

Training Room
A place to practice jedi skills.  There is a door to the north and an exit to the south. There is a bench by the wall.

Drong is here.

Yoda is here.

>test table
(Testing.)

>[1] open left drawer
You open the left drawer, revealing a light sabre.

>[2] open right drawer
You open the right drawer, revealing a battery.

>[3] get battery
(a battery)
Taken.

>[4] get sabre
Taken.

>[5] put battery in sabre
(a battery in the light sabre)
(first opening the light sabre)
(then closing the light sabre's battery compartment)

>[6] press button
The light sabre's blade now glows blue.

>get battery
That seems to be a part of the light sabre.

"wrrym"

>spar with yoda
(with the light sabre)
Yoda performs an elegant backflip to avoid your well aimed stroke.
Yoda says "To answer power with power, the Jedi way this is not. In this war, a danger there is, of losing who we are."

Your experience points increases by 7.

>spar with yoda
(with the light sabre)
Yoda side steps your clumsy maneuver.
Yoda says "Always pass on what you have learned."

Your experience points increases by 4.  Yoda says "You're training is now complete!".  The force feels stronger in you now.  Drong will be you new padawan, Master Keav
"wrrym"

>spar with yoda
(with the light sabre)
Yoda performs an elegant backflip to avoid your well aimed stroke.
Yoda says "When you look at the dark side, careful you must be. For the dark side looks back."

"hrrrm"

>spar with yoda
(with the light sabre)
Yoda strikes like a viper while seeming to hover outside your range.
Yoda says "Already know you that which you need."

"wrrym"

>spar with yoda
(with the light sabre)
Yoda easilly evades your reach.
Yoda says "To answer power with power, the Jedi way this is not. In this war, a danger there is, of losing who we are."

>spar with yoda
(with the light sabre)
Yoda side steps your clumsy maneuver.
Yoda says "A Jedi's strength flows from the Force."

>spar with yoda
(with the light sabre)
Yoda easilly evades your reach.
Yoda says "Through the Force, things you will see. Other places. The future...the past. Old friends long gone. "

"pop"

>s
Arena
Sand, blood, iron. These festivals are normally held on hot days, but the sun has gone behind a cloud and fat drops of rain now and then spatter the arena floor.

A clone warrior faces you, wielding a laser rifle and a clone blaster.

A bounty hunter circles you, pointing a shock rifle and a bounty blaster.

The clone warrior attacks you with the laser rifle, causing 5 points of damage!

The bounty hunter attacks you with the shock rifle, causing 3 points of damage!

Drong arrives from the north.

>n
Training Room
A place to practice jedi skills.  There is a door to the north and an exit to the south. There is a bench by the wall.

Yoda is here.

Drong arrives from the south.

>drong, follow me
"Okay."
Drong says "Ok, I will follow yourself."

>yoda, follow me
"Okay."
Yoda says "Ok, I will follow yourself."

>s
Arena
Sand, blood, iron. These festivals are normally held on hot days, but the sun has gone behind a cloud and fat drops of rain now and then spatter the arena floor.

A clone warrior faces you, wielding a laser rifle and a clone blaster.

A bounty hunter circles you, pointing a shock rifle and a bounty blaster.

The clone warrior attacks you with the laser rifle, causing 2 points of damage!

The bounty hunter attacks you with the bounty blaster, causing 3 points of damage!

Drong arrives from the north.

Yoda arrives from the north.

>attack clone with sabr
You can't see any such thing.

>attack clone with sabre
(the clone warrior with the light sabre)
You missed the clone warrior
Yoda attacks the clone warrior with the light sabre, causing 6 points of damage!

Drong attacks the bounty hunter with the light sabre, causing 2 points of damage!

The clone warrior attacks Yoda with the clone blaster, causing 0 points of damage!

The bounty hunter attacks you with the bounty blaster, causing 2 points of damage!

>attack hunter
(with the light sabre)
You attack the bounty hunter with the light sabre, causing 7 points of damage!
Looks like the bounty hunter is taking this personally.

Yoda attacks the clone warrior with the light sabre, causing 4 points of damage!

Drong attacks the bounty hunter with the light sabre, causing 0 points of damage!

The clone warrior attacks you with the laser rifle, causing 4 points of damage!

The bounty hunter attacks Drong with the shock rifle, causing 2 points of damage!

>n
Training Room
A place to practice jedi skills.  There is a door to the north and an exit to the south. There is a bench by the wall.

Drong arrives from the south.

Yoda arrives from the south.

The bounty hunter arrives from the south.

"hrrrm"

>attack hunter
(with the light sabre)
You attack the bounty hunter with the light sabre, causing 3 points of damage!

The bounty hunter attacks you with the shock rifle, causing 1 point of damage!

Yoda attacks the bounty hunter with the light sabre, causing 7 points of damage!

Drong attacked the bounty hunter with the light sabre, killing the bounty hunter!

"vrrrm"

>attack hunter
You can't see any such thing.

>s
Arena
Sand, blood, iron. These festivals are normally held on hot days, but the sun has gone behind a cloud and fat drops of rain now and then spatter the arena floor.

A clone warrior faces you, wielding a laser rifle and a clone blaster.

The clone warrior attacks you with the clone blaster, finishing you off!

    *** The End ***

In that game you scored 0 out of a possible 0, in 24 turns.

Would you like to RESTART, RESTORE a saved game, QUIT or UNDO the last command?

* * *

>test table
(Testing.)

>[1] open left drawer
You open the left drawer, revealing a light sabre.

>[2] open right drawer
You open the right drawer, revealing a battery.

>[3] get battery
(a battery)
Taken.

>[4] get sabre
Taken.

>[5] put battery in sabre
(a battery in the light sabre)
(first opening the light sabre)
(then closing the light sabre's battery compartment)

>[6] press button
The light sabre's blade now glows blue.

>spar with yoda
(with the light sabre)
Yoda performs an elegant backflip to avoid your well aimed stroke.
Yoda says "The dark side clouds everything. Impossible to see the light, the future is."

Your experience points increases by 5.

>spar with yoda
(with the light sabre)
Yoda easilly evades your reach.
Yoda says "You must unlearn what you have learned."

Your experience points increases by 3.  
"vrrrm"

>spar with yoda
(with the light sabre)
Yoda side steps your clumsy maneuver.
Yoda says "Always in motion is the future."

Your experience points increases by 4.  Yoda says "You're training is now complete!".  The force feels stronger in you now.  Drong will be you new padawan, Master Keav

>spar with yoda
(with the light sabre)
Yoda easilly evades your reach.
Yoda says "Already know you that which you need."

>spar with yoda
(with the light sabre)
Yoda strikes like a viper while seeming to hover outside your range.
Yoda says "A Jedi's strength flows from the Force."

>spar with yoda
(with the light sabre)
Yoda easilly evades your reach.
Yoda says "Always pass on what you have learned."

"wrrym"

>spar with yoda
(with the light sabre)
Yoda side steps your clumsy maneuver.
Yoda says "Blind we are, if creation of this clone army we could not see."

>spar with yoda
(with the light sabre)
Yoda performs an elegant backflip to avoid your well aimed stroke.
Yoda says "You will know ...the good from the bad… when you are calm, at peace. Passive. A Jedi uses the Force for knowledge and defense, never for attack."

"snap"

>spar with yoda
(with the light sabre)
Yoda easilly evades your reach.
Yoda says "You think Yoda stops teaching, just because his student does not want to hear? A teacher Yoda is. Yoda teaches like drunkards drink, like killers kill."

"pop"

>spar with yoda
(with the light sabre)
Yoda side steps your clumsy maneuver.
Yoda says "A Jedi must have the deepest commitment, the most serious mind. "

>spar with yoda
(with the light sabre)
Yoda performs an elegant backflip to avoid your well aimed stroke.
Yoda says "Clear your mind must be, if you are to find the villains behind this plot."

>spar with yoda
(with the light sabre)
Yoda side steps your clumsy maneuver.
Yoda says "Truly how wonderful the mind of a child is."

>spar with yoda
(with the light sabre)
Yoda easilly evades your reach.
Yoda says "Ohhh. Great warrior. Wars not make one great."

"crackle"

>spar with yoda
(with the light sabre)
Yoda strikes like a viper while seeming to hover outside your range.
Yoda says "I cannot teach him. The boy has no patience."

>spar with yoda
(with the light sabre)
Yoda easilly evades your reach.
Yoda says "You must unlearn what you have learned."

>spar with yoda
(with the light sabre)
Yoda strikes like a viper while seeming to hover outside your range.
Yoda says "Many of the truths that we cling to depend on our point of view."

>spar with yoda
(with the light sabre)
Yoda easilly evades your reach.
Yoda says "Already know you that which you need."

>spar with yoda
(with the light sabre)
Yoda side steps your clumsy maneuver.
Yoda says "You will know ...the good from the bad… when you are calm, at peace. Passive. A Jedi uses the Force for knowledge and defense, never for attack."

>spar with yoda
(with the light sabre)
Yoda strikes like a viper while seeming to hover outside your range.
Yoda says "Blind we are, if creation of this clone army we could not see."

"pop"

>spar with yoda
(with the light sabre)
Yoda performs an elegant backflip to avoid your well aimed stroke.
Yoda says "Truly how wonderful the mind of a child is."

>spar with yoda
(with the light sabre)
Yoda strikes like a viper while seeming to hover outside your range.
Yoda says "Many of the truths that we cling to depend on our point of view."

>spar with yoda
(with the light sabre)
Yoda easilly evades your reach.
Yoda says "Blind we are, if creation of this clone army we could not see."

"snap"

>spar with yoda
(with the light sabre)
Yoda strikes like a viper while seeming to hover outside your range.
Yoda says "Through the Force, things you will see. Other places. The future...the past. Old friends long gone. "

I beg your pardon?

>spar with yoda
(with the light sabre)
Yoda performs an elegant backflip to avoid your well aimed stroke.
Yoda says "You will find only what you bring in."

>spar with yoda
(with the light sabre)
Yoda easilly evades your reach.
Yoda says "A Jedi must have the deepest commitment, the most serious mind. "

>spar with yoda
(with the light sabre)
Yoda performs an elegant backflip to avoid your well aimed stroke.
Yoda says "You think Yoda stops teaching, just because his student does not want to hear? A teacher Yoda is. Yoda teaches like drunkards drink, like killers kill."

>spar with yoda
(with the light sabre)
Yoda side steps your clumsy maneuver.
Yoda says "And well you should not. For my ally in the Force. And a powerful ally it is. Life creates it, makes it grow. It's energy surrounds us and binds us. Luminous beings are we...(Yoda pinches Luke's shoulder)...not this crude matter. (a sweeping gesture) You must feel the Force around you. (gesturing) Here, between you...me...the tree...the rock...everywhere! Yes, even between this land and that ship!"

"pop"

>spar with yoda
(with the light sabre)
Yoda performs an elegant backflip to avoid your well aimed stroke.
Yoda says "Always two there are, a master and an apprentice."

>spar with yoda
(with the light sabre)
Yoda easilly evades your reach.
Yoda says "Try not. Do or do not, there is no try."

"crackle"

>spar with yoda
(with the light sabre)
Yoda side steps your clumsy maneuver.
Yoda says "To answer power with power, the Jedi way this is not. In this war, a danger there is, of losing who we are."

>spar with yoda
(with the light sabre)
Yoda easilly evades your reach.
Yoda says "Already know you that which you need."

>spar with yoda
(with the light sabre)
Yoda performs an elegant backflip to avoid your well aimed stroke.
Yoda says "Always pass on what you have learned."

The light sabre is obviously going to go out quite soon.

>x sabre
The light sabre has a button at the hilt, and concealed compartment.

The light sabre is currently switched on.

"pop"

>x sabre
The light sabre has a button at the hilt, and concealed compartment.

The light sabre is currently switched on.

The light sabre loses power and switches off!

The light sabre's blue blade is extinguished.

>open sabre
You open the light sabre's battery compartment, revealing a dead battery.

>get battery
(a dead battery)
Taken.

>drop dead battery
You can't see any such thing.

>drop batter
You can't see any such thing.

>drop battery
(a dead battery)
Dropped.

>look
Training Room
A place to practice jedi skills.  There is a door to the north and an exit to the south. There is a bench by the wall.

Drong is here.

Yoda is here.

You can also see a dead battery here.

* * *

>spar with yoda
(with the light sabre)
Yoda strikes like a viper while seeming to hover outside your range.
Yoda says "Through the Force, things you will see. Other places. The future...the past. Old friends long gone. "

>spar with yoda
(with the light sabre)
Yoda side steps your clumsy maneuver.
Yoda says "Always in motion is the future."

>spar with yoda
(with the light sabre)
Yoda performs an elegant backflip to avoid your well aimed stroke.
Yoda says "You must unlearn what you have learned."

"pop"

>spar with yoda
(with the light sabre)
Yoda side steps your clumsy maneuver.
Yoda says "Death is a natural part of life. Rejoice for those around you who transform into the Force. Mourn them do not. Miss them do not. Attachment leads to jealously. The shadow of greed, that is."

>spar with yoda
(with the light sabre)
Yoda easilly evades your reach.
Yoda says "You will know ...the good from the bad… when you are calm, at peace. Passive. A Jedi uses the Force for knowledge and defense, never for attack."

"hrrrm"

>spar with yoda
(with the light sabre)
Yoda strikes like a viper while seeming to hover outside your range.
Yoda says "Yes, a Jedi's strength flows from the Force. But beware of the dark side. Anger, fear, aggression; the dark side of the Force are they. Easily they flow, quick to join you in a fight. If once you start down the dark path, forever will it dominate your destiny, consume you it will, as it did Obi-Wan's apprentice."

>spar with yoda
(with the light sabre)
Yoda side steps your clumsy maneuver.
Yoda says "You think Yoda stops teaching, just because his student does not want to hear? A teacher Yoda is. Yoda teaches like drunkards drink, like killers kill."

>spar with yoda
(with the light sabre)
Yoda easilly evades your reach.
Yoda says "In a dark place we find ourselves, and a little more knowledge lights our way."

"wrrym"

>spar with yoda
(with the light sabre)
Yoda performs an elegant backflip to avoid your well aimed stroke.
Yoda says "Many of the truths that we cling to depend on our point of view."

>spar with yoda
(with the light sabre)
Yoda side steps your clumsy maneuver.
Yoda says "Ohhh. Great warrior. Wars not make one great."

The light sabre is obviously going to go out quite soon.

>spar with yoda
(with the light sabre)
Yoda performs an elegant backflip to avoid your well aimed stroke.
Yoda says "And well you should not. For my ally in the Force. And a powerful ally it is. Life creates it, makes it grow. It's energy surrounds us and binds us. Luminous beings are we...(Yoda pinches Luke's shoulder)...not this crude matter. (a sweeping gesture) You must feel the Force around you. (gesturing) Here, between you...me...the tree...the rock...everywhere! Yes, even between this land and that ship!"

>spar with yoda
(with the light sabre)
Yoda strikes like a viper while seeming to hover outside your range.
Yoda says "I cannot teach him. The boy has no patience."

The light sabre loses power and switches off!

The light sabre's blue blade is extinguished.

>open sabre
You open the light sabre's battery compartment, revealing a dead battery.

>get dea battery
You can't see any such thing.

>get dead battery
Taken.

>drop battery
(a dead battery)
Dropped.

* * *

>look
Training Room
A place to practice jedi skills.  There is a door to the north and an exit to the south. There is a bench by the wall.

Drong is here.

Yoda is here.

You can also see a dead battery here.

>get dead battery
Taken.

* * *

>test table
(Testing.)

>[1] open left drawer
You open the left drawer, revealing a light sabre.

>[2] open right drawer
You open the right drawer, revealing a battery.

>[3] get battery
(a battery)
Taken.

>[4] get sabre
Taken.

>[5] put battery in sabre
(a battery in the light sabre)
(first opening the light sabre)
(then closing the light sabre's battery compartment)

>[6] press button
The light sabre's blade now glows blue.

>test spar
(Testing.)

>[1] spar with yoda with sabre
Yoda easilly evades your reach.
Yoda says "Train yourself to let go of everything you fear to lose."

Your experience points increases by 3.  

>[2] again
Yoda strikes like a viper while seeming to hover outside your range.
Yoda says "Ready are you? What know you of ready? For eight hundred years have I trained Jedi. My own counsel will I keep on who is to be trained. A Jedi must have the deepest commitment, the most serious mind. This one a long time have I watched. All his life has he looked away... to the future, to the horizon. Never his mind on where he was. Hmm? What he was doing. Hmph. Adventure. Heh. Excitement. Heh. A Jedi craves not these things. You are reckless."

Your experience points increases by 4.  

>[3] again
Yoda performs an elegant backflip to avoid your well aimed stroke.
Yoda says "Ohhh. Great warrior. Wars not make one great."

Your experience points increases by 5.  

>[4] again
Yoda side steps your clumsy maneuver.
Yoda says "Always pass on what you have learned."

Your experience points increases by 3.  
"pop"
>[5] again
Yoda easilly evades your reach.
Yoda says "Ohhh. Great warrior. Wars not make one great."

Your experience points increases by 6.  
"snap"
>[6] s

Arena
Sand, blood, iron. These festivals are normally held on hot days, but the sun has gone behind a cloud and fat drops of rain now and then spatter the arena floor.

A clone warrior faces you, wielding a laser rifle and a clone blaster.

A bounty hunter circles you, pointing a shock rifle and a bounty blaster.

The clone warrior attacks you with the laser rifle, causing 3 points of damage!

The bounty hunter attacks you with the shock rifle, causing 6 points of damage!

"vrrrm"

>n
Training Room
A place to practice jedi skills.  There is a door to the north and an exit to the south. There is a bench by the wall.

Drong is here.

Yoda is here.

"snap"

>spar with yoda
(with the light sabre)
Yoda performs an elegant backflip to avoid your well aimed stroke.
Yoda says "I cannot teach him. The boy has no patience."

"hrrrm"

>spar with yoda
(with the light sabre)
Yoda strikes like a viper while seeming to hover outside your range.
Yoda says "I cannot teach him. The boy has no patience."

"wrrym"

>yoda, follow me
"Okay."
Yoda says "Ok, I will follow yourself."

>s
Arena
Sand, blood, iron. These festivals are normally held on hot days, but the sun has gone behind a cloud and fat drops of rain now and then spatter the arena floor.

A clone warrior faces you, wielding a laser rifle and a clone blaster.

A bounty hunter circles you, pointing a shock rifle and a bounty blaster.

The clone warrior attacks you with the laser rifle, causing 7 points of damage!

The bounty hunter attacks you with the shock rifle, causing 1 point of damage!

Drong arrives from the north.

Yoda arrives from the north.

>n
Training Room
A place to practice jedi skills.  There is a door to the north and an exit to the south. There is a bench by the wall.

Drong arrives from the south.

Yoda arrives from the south.

>s
Arena
Sand, blood, iron. These festivals are normally held on hot days, but the sun has gone behind a cloud and fat drops of rain now and then spatter the arena floor.

A clone warrior faces you, wielding a laser rifle and a clone blaster.

A bounty hunter circles you, pointing a shock rifle and a bounty blaster.

The clone warrior attacks you with the clone blaster, finishing you off!

The bounty hunter attacks you with the shock rifle, finishing you off!

    *** The End ***

In that game you scored 0 out of a possible 0, in 19 turns.

Would you like to RESTART, RESTORE a saved game, QUIT or UNDO the last command?

* * *

>n
Training Room
A place to practice jedi skills.  There is a door to the north and an exit to the south. There is a bench by the wall.

Drong is here.

Yoda is here.

"snap"

>yoda, follow me
"Okay."
Yoda says "Ok, I will follow yourself."

>s
Arena
Sand, blood, iron. These festivals are normally held on hot days, but the sun has gone behind a cloud and fat drops of rain now and then spatter the arena floor.

A clone warrior faces you, wielding a laser rifle and a clone blaster.

A bounty hunter circles you, pointing a shock rifle and a bounty blaster.

The clone warrior attacks you with the laser rifle, causing 5 points of damage!

The bounty hunter attacks you with the shock rifle, causing 1 point of damage!

Yoda arrives from the north.

>kill clone
(the clone warrior with the light sabre)
You missed the clone warrior
Yoda attacks the bounty hunter with the light sabre, causing 6 points of damage!

The clone warrior attacks you with the laser rifle, causing 7 points of damage!

The bounty hunter attacks you with the shock rifle, causing 6 points of damage!

>kill clone
(the clone warrior with the light sabre)
You missed the clone warrior
Yoda attacks the clone warrior with the light sabre, causing 7 points of damage!

The clone warrior attacks you with the clone blaster, causing 1 point of damage!

The bounty hunter attacks you with the bounty blaster, finishing you off!

    *** The End ***

In that game you scored 0 out of a possible 0, in 17 turns.

Would you like to RESTART, RESTORE a saved game, QUIT or UNDO the last command?

* * *

I beg your pardon?

>yoda, follow
You seem to want to talk to someone, but I can't see whom.

>yoda, follow me
You seem to want to talk to someone, but I can't see whom.

>n
Training Room
A place to practice jedi skills.  There is a door to the north and an exit to the south. There is a bench by the wall.

Yoda is here.

Drong arrives from the south.

>yoda, follow me
"Okay."
Yoda says "Ok, I will follow yourself."

>s
Arena
Sand, blood, iron. These festivals are normally held on hot days, but the sun has gone behind a cloud and fat drops of rain now and then spatter the arena floor.

A clone warrior faces you, wielding a laser rifle and a clone blaster.

A bounty hunter circles you, pointing a shock rifle and a bounty blaster.

The clone warrior attacks you with the laser rifle, causing 0 points of damage!

The bounty hunter attacks you with the bounty blaster, causing 4 points of damage!

Drong arrives from the north.

Yoda arrives from the north.

>kill clone
(the clone warrior with the light sabre)
You attack the clone warrior with the light sabre, causing 2 points of damage!
Looks like the clone warrior is taking this personally.

Yoda attacks the bounty hunter with the light sabre, causing 4 points of damage!

Drong attacks the bounty hunter with the light sabre, causing 1 point of damage!

The clone warrior attacks you with the laser rifle, causing 6 points of damage!

The bounty hunter attacks Drong with the bounty blaster, causing 4 points of damage!

>kill clone
(the clone warrior with the light sabre)
You attack the clone warrior with the light sabre, causing 9 points of damage!

Yoda attacks the bounty hunter with the light sabre, causing 8 points of damage!

Drong attacks the bounty hunter with the light sabre, causing 1 point of damage!

The clone warrior attacks you with the laser rifle, finishing you off!

The bounty hunter attacks Drong with the shock rifle, causing 3 points of damage!

    *** The End ***

In that game you scored 0 out of a possible 0, in 17 turns.

Would you like to RESTART, RESTORE a saved game, QUIT or UNDO the last command?

* * *

StarWords
An Interactive Fiction by Campbell Burgess
Release 1 / Serial number 130920 / Inform 7 build 6G60 (I6/v6.32 lib 6/12N) SD

Training Room
A place to practice jedi skills.  There is a door to the north and an exit to the south. There is a bench by the wall.

Drong is here.

Yoda is here.

>yoda, fight yoda
(with the green light sabre)
Yoda  says "Don't be absurd."

Yoda is unable to do that.