StarWords
An Interactive Fiction by Campbell Burgess
Release 1 / Serial number 130911 / Inform 7 build 6G60 (I6/v6.32 lib 6/12N) SD

Training Room
A place to practice jedi skills.  There is a door to the north and an exit to the south. There is a bench by the wall.

Drong is here.

Yoda is here.

>say hi to drong
There is no reply.

>say hi to yoda
There is no reply.

>n
Darkness
It is pitch dark, and you can't see a thing.

>inventory
You are carrying nothing.

>s
Training Room
A place to practice jedi skills.  There is a door to the north and an exit to the south. There is a bench by the wall.

Drong is here.

Yoda is here.

>s
Darkness
It is pitch dark, and you can't see a thing.

>s
You can't go that way.

>e
You can't go that way.

>w
You can't go that way.

>n
Training Room
A place to practice jedi skills.  There is a door to the north and an exit to the south. There is a bench by the wall.

Drong is here.

Yoda is here.

>bench
That's not a verb I recognise.

>look at bench
It is an ordinary bench with two drawers, left and right

>open the draws
You can't see any such thing.

>open the bench
That's not something you can open.

>open the drawers
You can't see any such thing.

>open the left drawer
You open the left drawer, revealing a light sabre.

>take sabre
Taken.

>open right sabre
I only understood you as far as wanting to open the right drawer.

>open right drawer
You open the right drawer, revealing a D battery.

>get all
D battery: Taken.
blue light sabre: That seems to belong to Drong.
green light sabre: That seems to belong to Yoda.

>open saber
You can't see any such thing.

>open sabre
You open the light sabre's battery compartment.

>place battery in sabre
That's not a verb I recognise.

>put battery in sabre
(the D battery in the light sabre)
(first opening the light sabre)
That's already open.

(then closing the light sabre's battery compartment)

>x sabre
The light sabre has a button at the hilt, and concealed compartment.

The light sabre is currently switched off.

>activate sabre
That's not a verb I recognise.

>push button
It is now on.

>x sabre
It's blade is glowing purple.

The light sabre is currently switched on.

"wrrym"

>look
Training Room
A place to practice jedi skills.  There is a door to the north and an exit to the south. There is a bench by the wall.

Drong is here.

Yoda is here.

>kill Drong
(with the light sabre)
Ooh I think this is a mistake.
You attack Drong with the light sabre, causing 8 points of damage!

"wrrym"

>kill Yoda
(with the light sabre)
Ooh I think this is a mistake.
You attack Yoda with the light sabre, causing 10 points of damage!

>n
closet
This is a dead end. You'll have to go back the way you came.

>s
Training Room
A place to practice jedi skills.  There is a door to the north and an exit to the south. There is a bench by the wall.

Drong is here.

Yoda is here.

"hrrrm"

>s
Arena
Sand, blood, iron. These festivals are normally held on hot days, but the sun has gone behind a cloud and fat drops of rain now and then spatter the arena floor.

A clone warrior faces you, wielding a laser rifle and a clone blaster.

A bounty hunter circles you, pointing a shock rifle and a bounty blaster.

Looks like the clone warrior is taking this personally.

The clone warrior attacks you with the laser rifle, causing 1 point of damage!

The bounty hunter attacks you with the shock rifle, finishing you off!

    *** The End ***

In that game you scored 0 out of a possible 0, in 27 turns.

Would you like to RESTART, RESTORE a saved game, QUIT or UNDO the last command?

* * *

StarWords
An Interactive Fiction by Campbell Burgess
Release 1 / Serial number 130911 / Inform 7 build 6G60 (I6/v6.32 lib 6/12N) SD

Training Room
A place to practice jedi skills.  There is a door to the north and an exit to the south. There is a bench by the wall.

Drong is here.

Yoda is here.

>s
Darkness
It is pitch dark, and you can't see a thing.

>n
Training Room
A place to practice jedi skills.  There is a door to the north and an exit to the south. There is a bench by the wall.

Drong is here.

Yoda is here.

>s
Darkness
It is pitch dark, and you can't see a thing.

* * *

>n
Training Room
A place to practice jedi skills.  There is a door to the north and an exit to the south. There is a bench by the wall.

Drong is here.

Yoda is here.

>test table
(Testing.)

>[1] open left drawer
You open the left drawer, revealing a light sabre.

>[2] open right drawer
You open the right drawer, revealing a D battery.

>[3] get d battery
Taken.

>[4] get sabre
Taken.

>[5] put battery in sabre
(the D battery in the light sabre)
(first opening the light sabre)
(then closing the light sabre's battery compartment)

>press button
It is now on.

>s
Arena
Sand, blood, iron. These festivals are normally held on hot days, but the sun has gone behind a cloud and fat drops of rain now and then spatter the arena floor.

A clone warrior faces you, wielding a laser rifle and a clone blaster.

A bounty hunter circles you, pointing a shock rifle and a bounty blaster.

The clone warrior attacks you with the laser rifle, causing 6 points of damage!

The bounty hunter attacks you with the bounty blaster, causing 3 points of damage!

>n
Training Room
A place to practice jedi skills.  There is a door to the north and an exit to the south. There is a bench by the wall.

Drong is here.

Yoda is here.

The clone warrior arrives from the south.

The bounty hunter arrives from the south.

>look
Training Room
A place to practice jedi skills.  There is a door to the north and an exit to the south. There is a bench by the wall.

A bounty hunter circles you, pointing a shock rifle and a bounty blaster.

A clone warrior faces you, wielding a laser rifle and a clone blaster.

Drong is here.

Yoda is here.

The bounty hunter attacks Drong with the bounty blaster, causing 5 points of damage!

The clone warrior attacks Drong with the clone blaster, causing 5 points of damage!

Drong attacks the bounty hunter with the blue light sabre, causing 1 point of damage!

You must supply a second noun.

>relations
Ally relates people to each other:
  Drong  <=>  yourself
  Yoda  <=>  yourself
  Yoda  <=>  Drong
  The bounty hunter  <=>  the clone warrior
Enemy relates people to each other:
  The clone warrior  <=>  yourself
  The clone warrior  <=>  Drong
  The clone warrior  <=>  Yoda
  The bounty hunter  <=>  yourself
  The bounty hunter  <=>  Drong
  The bounty hunter  <=>  Yoda

* * *

StarWords
An Interactive Fiction by Campbell Burgess
Release 1 / Serial number 130911 / Inform 7 build 6G60 (I6/v6.32 lib 6/12N) SD

Training Room
A place to practice jedi skills.  There is a door to the north and an exit to the south. There is a bench by the wall.

Drong is here.

Yoda is here.

>test table
(Testing.)

>[1] open left drawer
You open the left drawer, revealing a light sabre.

>[2] open right drawer
You open the right drawer, revealing a D battery.

>[3] get d battery
Taken.

>[4] get sabre
Taken.

>[5] put battery in sabre
(the D battery in the light sabre)
(first opening the light sabre)
(then closing the light sabre's battery compartment)

>test sabre
(Testing.)

>[1] get sabre
You already have that.

>[2] open it
You open the light sabre's battery compartment, revealing a D battery.

>[3] put battery in it
Which do you mean, the light sabre's battery compartment or the D battery?

>[4] press button
It is now on.

>s
Arena
Sand, blood, iron. These festivals are normally held on hot days, but the sun has gone behind a cloud and fat drops of rain now and then spatter the arena floor.

A clone warrior faces you, wielding a laser rifle and a clone blaster.

A bounty hunter circles you, pointing a shock rifle and a bounty blaster.

The clone warrior attacks you with the clone blaster, causing 2 points of damage!

The bounty hunter attacks you with the bounty blaster, causing 3 points of damage!

>hit clone with sabre
(the clone warrior with the light sabre)
You attack the clone warrior with the light sabre, causing 4 points of damage!

Looks like the clone warrior is taking this personally.

The clone warrior attacks you with the laser rifle, causing 1 point of damage!

The bounty hunter attacks you with the shock rifle, causing 0 points of damage!

>n
Training Room
A place to practice jedi skills.  There is a door to the north and an exit to the south. There is a bench by the wall.

Drong is here.

Yoda is here.

The clone warrior arrives from the south.

>hit clone with sabre
(the clone warrior with the light sabre)
You missed the clone warrior
The clone warrior attacks Drong with the clone blaster, causing 5 points of damage!

Drong attacks the clone warrior with the blue light sabre, causing 14 points of damage!

Yoda attacked the clone warrior with the green light sabre, killing the clone warrior!

"crackle"

* * *

>test table
(Testing.)

>[1] open left drawer
You open the left drawer, revealing a light sabre.

>[2] open right drawer
You open the right drawer, revealing a D battery.

>[3] get d battery
Taken.

>[4] get sabre
Taken.

>[5] put battery in sabre
(the D battery in the light sabre)
(first opening the light sabre)
(then closing the light sabre's battery compartment)

>push butt
You can't see any such thing.

>push button
It is now on.

>spar yoda
I didn't understand that sentence.

>spar with Yoda
(with the light sabre)
Yoda side steps your clumsy maneuver.
Yoda says "A Jedi must have the deepest commitment, the most serious mind. "

Your experience points increases by 6.  
"vrrrm"

>spar with Yoda
(with the light sabre)
Yoda performs an elegant backflip to avoid your well aimed stroke.
Yoda says "In a dark place we find ourselves, and a little more knowledge lights our way."

Your experience points increases by 5.

>spar with Yoda
(with the light sabre)
Yoda strikes like a viper while seeming to hover outside your range.
Yoda says "In a dark place we find ourselves, and a little more knowledge lights our way."

Your experience points increases by 4.

>spar with Yoda
(with the light sabre)
Yoda performs an elegant backflip to avoid your well aimed stroke.
Yoda says "Blind we are, if creation of this clone army we could not see."

Your experience points increases by 1.

>spar with Yoda
(with the light sabre)
Yoda strikes like a viper while seeming to hover outside your range.
Yoda says "Named must your fear be before banish it you can."

Your experience points increases by 8.  
"hrrrm"

>spar with Yoda
(with the light sabre)
Yoda performs an elegant backflip to avoid your well aimed stroke.
Yoda says "Always two there are, a master and an apprentice."

Your experience points increases by 3.

>spar with Yoda
(with the light sabre)
Yoda side steps your clumsy maneuver.
Yoda says "You must unlearn what you have learned."

Your experience points increases by 6.

>spar with Yoda
(with the light sabre)
Yoda strikes like a viper while seeming to hover outside your range.
Yoda says "Ohhh. Great warrior. Wars not make one great."

Your experience points increases by 5.  
"pop"

>spar with Yoda
(with the light sabre)
Yoda side steps your clumsy maneuver.
Yoda says "You must unlearn what you have learned."

Your experience points increases by 0.  
"crackle"

>spar with Yoda
(with the light sabre)
Yoda strikes like a viper while seeming to hover outside your range.
Yoda says "Ready are you? What know you of ready? For eight hundred years have I trained Jedi. My own counsel will I keep on who is to be trained. A Jedi must have the deepest commitment, the most serious mind. This one a long time have I watched. All his life has he looked away... to the future, to the horizon. Never his mind on where he was. Hmm? What he was doing. Hmph. Adventure. Heh. Excitement. Heh. A Jedi craves not these things. You are reckless."

Your experience points increases by 0.

>spar with Yoda
(with the light sabre)
Yoda easilly evades your reach.
Yoda says "To answer power with power, the Jedi way this is not. In this war, a danger there is, of losing who we are."

Your experience points increases by 1.

>spar with Yoda
(with the light sabre)
Yoda side steps your clumsy maneuver.
Yoda says "Once you start down the dark path, forever will it dominate your destiny, consume you it will."

Your experience points increases by 5.  Yoda says "You're training is now complete!".  The force feels stronger in you now.  Drong will be you new padawan, Master Keav
"hrrrm"

>spar with Yoda
(with the light sabre)
Yoda strikes like a viper while seeming to hover outside your range.
Yoda says "Already know you that which you need."

>spar with Drong
(with the light sabre)
Drong drops under your blow then tells you to trust the force.

>spar with Drong
(with the light sabre)
Drong is surprised momentarilly by your feint, but recovers and suggests you loosen your grip.

>spar with Drong
(with the light sabre)
Drong paries your thrust then tells you to trust the force.

>trustthe force
That's not a verb I recognise.

>trust the force
That's not a verb I recognise.

>s
Arena
Sand, blood, iron. These festivals are normally held on hot days, but the sun has gone behind a cloud and fat drops of rain now and then spatter the arena floor.

A clone warrior faces you, wielding a laser rifle and a clone blaster.

A bounty hunter circles you, pointing a shock rifle and a bounty blaster.

Looks like the clone warrior is taking this personally.

The clone warrior attacks you with the clone blaster, causing 0 points of damage!

The bounty hunter attacks you with the bounty blaster, causing 3 points of damage!

Drong arrives from the north.

>kill bounty hunter
(with the light sabre)
You attack the bounty hunter with the light sabre, causing 17 points of damage!

Drong attacks the bounty hunter with the blue light sabre, causing 0 points of damage!

Looks like the clone warrior is taking this personally.

The clone warrior attacks you with the laser rifle, causing 1 point of damage!

The bounty hunter attacks Drong with the bounty blaster, causing 3 points of damage!

"pop"

>kill bounty hunter
(with the light sabre)
You attack the bounty hunter with the light sabre, causing 1 point of damage!

Drong attacks the clone warrior with the blue light sabre, causing 14 points of damage!

Looks like the clone warrior is taking this personally.

The clone warrior attacks you with the laser rifle, causing 5 points of damage!

The bounty hunter attacks Drong with the shock rifle, causing 3 points of damage!

>kill bounty hunter
(with the light sabre)
You attack with the light sabre, killing the bounty hunter!

Drong attacks the clone warrior with the blue light sabre, causing 3 points of damage!

The clone warrior attacks Drong with the laser rifle, causing 7 points of damage!

>n
Training Room
A place to practice jedi skills.  There is a door to the north and an exit to the south. There is a bench by the wall.

Yoda is here.

Drong arrives from the south.

The clone warrior arrives from the south.

>look
Training Room
A place to practice jedi skills.  There is a door to the north and an exit to the south. There is a bench by the wall.

A clone warrior faces you, wielding a laser rifle and a clone blaster.

Drong is here.

Yoda is here.

The clone warrior attacks Yoda with the laser rifle, causing 2 points of damage!

Drong attacked the clone warrior with the blue light sabre, killing the clone warrior!

I beg your pardon?

I beg your pardon?

>relations
Ally relates people to each other:
  Drong  <=>  yourself
  Yoda  <=>  yourself
  Yoda  <=>  Drong
  The bounty hunter  <=>  the clone warrior
Enemy relates people to each other:
  The clone warrior  <=>  yourself
  The clone warrior  <=>  Drong
  The clone warrior  <=>  Yoda
  The bounty hunter  <=>  yourself
  The bounty hunter  <=>  Drong
  The bounty hunter  <=>  Yoda

>kill myself
(with the light sabre)
If you are very lucky you'll live long enough to regret this.
You attack yourself with the light sabre, causing 10 points of damage!

"vrrrm"

>kill myself
(with the light sabre)
You attack with the light sabre, killing yourself!

I beg your pardon?

>kill myself
What do you want to kill yourself with?

>look
Training Room
A place to practice jedi skills.  There is a door to the north and an exit to the south. There is a bench by the wall.

Drong is here.

Yoda is here.

You can also see a light sabre, a clone blaster and a laser rifle here.

>get all
light sabre: Taken.
clone blaster: Taken.
laser rifle: Taken.
blue light sabre: That seems to belong to Drong.
green light sabre: That seems to belong to Yoda.

>kill myself
What do you want to kill yourself with?

>sabre
You attack with the light sabre, killing yourself!

* * *

>press button
It is now on.

>spar with drong
(with the light sabre)
Drong is surprised momentarilly by your feint, but recovers with a smile and a playful kick in the ass.
Your experience points increases by 0.

>spar with drong
(with the light sabre)
Drong blocks your advance and suggests you loosen your grip.
Your experience points increases by 0.

>spar with drong
(with the light sabre)
Drong is surprised momentarilly by your feint, but recovers then tells you to trust the force.
Your experience points increases by 0.  
"vrrrm"

>spar with drong
(with the light sabre)
Drong drops under your blow and suggests you loosen your grip.
Your experience points increases by 0.  
"wrrym"

>spar with drong
(with the light sabre)
Drong is surprised momentarilly by your feint, but recovers with a smile and a playful kick in the ass.
Your experience points increases by 0.  
"pop"

>spar with drong
(with the light sabre)
Drong paries your thrust then tells you to trust the force.
Your experience points increases by 2.

>spar with drong
(with the light sabre)
Drong is surprised momentarilly by your feint, but recovers with a smile and a playful kick in the ass.
Your experience points increases by 1.  
"hrrrm"

>spar with drong
(with the light sabre)
Drong drops under your blow and suggests you loosen your grip.
Your experience points increases by 0.

>spar with drong
(with the light sabre)
Drong paries your thrust then tells you to trust the force.
Your experience points increases by 1.  
"crackle"

>spar with drong
(with the light sabre)
Drong drops under your blow with a smile and a playful kick in the ass.
Your experience points increases by 0.

>spar with drong
(with the light sabre)
Drong blocks your advance and suggests you loosen your grip.
Your experience points increases by 2.

>spar with yoda
(with the light sabre)
Yoda strikes like a viper while seeming to hover outside your range.
Yoda says "Named must your fear be before banish it you can."

Your experience points increases by 2.  
"snap"

>spar with yoda
(with the light sabre)
Yoda easilly evades your reach.
Yoda says "Clear your mind must be, if you are to find the villains behind this plot."

Your experience points increases by 0.

>spar with yoda
(with the light sabre)
Yoda performs an elegant backflip to avoid your well aimed stroke.
Yoda says "Clear your mind must be, if you are to find the villains behind this plot."

Your experience points increases by 8.

>spar with yoda
(with the light sabre)
Yoda side steps your clumsy maneuver.
Yoda says "Train yourself to let go of everything you fear to lose."

Your experience points increases by 4.  
"vrrrm"

>spar with yoda
(with the light sabre)
Yoda easilly evades your reach.
Yoda says "Through the Force, things you will see. Other places. The future...the past. Old friends long gone. "

Your experience points increases by 1.  
"snap"

>spar with yoda
(with the light sabre)
Yoda side steps your clumsy maneuver.
Yoda says "You must unlearn what you have learned."

Your experience points increases by 2.  
"hrrrm"

>spar with yoda
(with the light sabre)
Yoda easilly evades your reach.
Yoda says "Yes, a Jedi's strength flows from the Force. But beware of the dark side. Anger, fear, aggression; the dark side of the Force are they. Easily they flow, quick to join you in a fight. If once you start down the dark path, forever will it dominate your destiny, consume you it will, as it did Obi-Wan's apprentice."

Your experience points increases by 1.

>spar with yoda
(with the light sabre)
Yoda side steps your clumsy maneuver.
Yoda says "Blind we are, if creation of this clone army we could not see."

Your experience points increases by 5.

>spar with yoda
(with the light sabre)
Yoda performs an elegant backflip to avoid your well aimed stroke.
Yoda says "Many of the truths that we cling to depend on our point of view."

Your experience points increases by 6.

>spar with yoda
(with the light sabre)
Yoda side steps your clumsy maneuver.
Yoda says "To answer power with power, the Jedi way this is not. In this war, a danger there is, of losing who we are."

Your experience points increases by 1.

* * *

>press button
It is now on.

>hit yoda with sabre
Ooh I think this is a mistake.
You attack Yoda with the light sabre, causing 10 points of damage!

* * *

>press button
It is now on.

>s
Arena
Sand, blood, iron. These festivals are normally held on hot days, but the sun has gone behind a cloud and fat drops of rain now and then spatter the arena floor.

A clone warrior faces you, wielding a laser rifle and a clone blaster.

A bounty hunter circles you, pointing a shock rifle and a bounty blaster.

The clone warrior attacks you with the laser rifle, causing 5 points of damage!

The bounty hunter attacks you with the bounty blaster, causing 5 points of damage!

>n
Training Room
A place to practice jedi skills.  There is a door to the north and an exit to the south. There is a bench by the wall.

Drong is here.

Yoda is here.

The clone warrior arrives from the south.

The bounty hunter arrives from the south.

"wrrym"

>attack clone with sabre
(the clone warrior with the light sabre)
You attack the clone warrior with the light sabre, causing 7 points of damage!

The bounty hunter attacks you with the shock rifle, causing 2 points of damage!

The clone warrior attacks you with the clone blaster, causing 5 points of damage!

Drong attacks the clone warrior with the blue light sabre, causing 11 points of damage!

Yoda attacks the clone warrior with the green light sabre, causing 2 points of damage!

>attack clone with sabre
(the clone warrior with the light sabre)
You attack with the light sabre, killing the clone warrior!

The bounty hunter attacks you with the shock rifle, causing 6 points of damage!

Drong attacks the bounty hunter with the blue light sabre, causing 4 points of damage!

Yoda attacks the bounty hunter with the green light sabre, causing 4 points of damage!

"hrrrm"

>s
Arena
Sand, blood, iron. These festivals are normally held on hot days, but the sun has gone behind a cloud and fat drops of rain now and then spatter the arena floor.

The bounty hunter arrives from the north.

>attack hunter with sabre
You attack the bounty hunter with the light sabre, causing 8 points of damage!

The bounty hunter attacks you with the bounty blaster, causing 2 points of damage!

"hrrrm"

>n
Training Room
A place to practice jedi skills.  There is a door to the north and an exit to the south. There is a bench by the wall.

Drong is here.

Yoda is here.

You can also see a clone blaster and a laser rifle here.

The bounty hunter arrives from the south.

>attack hunter with sabre
You attack the bounty hunter with the light sabre, causing 1 point of damage!

The bounty hunter attacks Drong with the shock rifle, causing 5 points of damage!

Drong attacked the bounty hunter with the blue light sabre, killing the bounty hunter!

"pop"

* * *

>n
Training Room
A place to practice jedi skills.  There is a door to the north and an exit to the south. There is a bench by the wall.

Drong is here.

Yoda is here.

The clone warrior arrives from the south.

The bounty hunter arrives from the south.

"wrrym"

>look
Training Room
A place to practice jedi skills.  There is a door to the north and an exit to the south. There is a bench by the wall.

A bounty hunter circles you, pointing a shock rifle and a bounty blaster.

A clone warrior faces you, wielding a laser rifle and a clone blaster.

Drong is here.

Yoda is here.

The bounty hunter attacks you with the bounty blaster, causing 0 points of damage!

The clone warrior attacks Drong with the laser rifle, causing 3 points of damage!

Drong attacks the bounty hunter with the blue light sabre, causing 5 points of damage!

Yoda attacks the clone warrior with the green light sabre, causing 4 points of damage!

"snap"

>attack hunter with sabre
You attack the bounty hunter with the light sabre, causing 8 points of damage!

The bounty hunter attacks you with the shock rifle, causing 7 points of damage!

The clone warrior attacks Yoda with the clone blaster, causing 0 points of damage!

Drong attacked the bounty hunter with the blue light sabre, killing the bounty hunter!

Yoda attacks the clone warrior with the green light sabre, causing 1 point of damage!

You must supply a noun.

>attack hunter with sabre
You can't see any such thing.

>attack clone with sabre
(the clone warrior with the light sabre)
You attack the clone warrior with the light sabre, causing 2 points of damage!

The clone warrior attacks Drong with the laser rifle, causing 7 points of damage!

Drong attacks the clone warrior with the blue light sabre, causing 6 points of damage!

Yoda attacks the clone warrior with the green light sabre, causing 4 points of damage!

You must supply a noun.

"snap"

>inventory
You are carrying:
  a light sabre (providing light)

The clone warrior attacks Yoda with the clone blaster, causing 1 point of damage!

Drong attacked the clone warrior with the blue light sabre, killing the clone warrior!

You must supply a noun.

You must supply a noun.

>look
Training Room
A place to practice jedi skills.  There is a door to the north and an exit to the south. There is a bench by the wall.

Drong is here.

Yoda is here.

You can also see a clone blaster, a laser rifle, a bounty blaster and a shock rifle here.

You must supply a noun.

You must supply a noun.

"hrrrm"

* * *

>press button
It is now on.

>attack yoda with sabre
Ooh I think this is a mistake.
You attack Yoda with the light sabre, causing 1 point of damage!

>attack yoda with sabre
If you are very lucky you'll live long enough to regret this.
You attack Yoda with the light sabre, causing 9 points of damage!

Yoda attacks you with the green light sabre, causing 0 points of damage!

"crackle"

>s
Arena
Sand, blood, iron. These festivals are normally held on hot days, but the sun has gone behind a cloud and fat drops of rain now and then spatter the arena floor.

A clone warrior faces you, wielding a laser rifle and a clone blaster.

A bounty hunter circles you, pointing a shock rifle and a bounty blaster.

The clone warrior attacks you with the laser rifle, causing 4 points of damage!

The bounty hunter attacks you with the bounty blaster, causing 2 points of damage!

Yoda arrives from the north.

"hrrrm"

>n
Training Room
A place to practice jedi skills.  There is a door to the north and an exit to the south. There is a bench by the wall.

Drong is here.

Yoda arrives from the south.

"snap"

* * *

>attack yoda with sabre
If you are very lucky you'll live long enough to regret this.
You attack Yoda with the light sabre, causing 9 points of damage!

Yoda attacks you with the green light sabre, causing 0 points of damage!

"crackle"

>attack yoda with sabre
You attack Yoda with the light sabre, causing 2 points of damage!
Looks like Yoda is taking this personally.

Yoda attacks you with the green light sabre, causing 1 point of damage!

"snap"

>s
Arena
Sand, blood, iron. These festivals are normally held on hot days, but the sun has gone behind a cloud and fat drops of rain now and then spatter the arena floor.

A clone warrior faces you, wielding a laser rifle and a clone blaster.

A bounty hunter circles you, pointing a shock rifle and a bounty blaster.

The clone warrior attacks you with the clone blaster, causing 0 points of damage!

The bounty hunter attacks you with the bounty blaster, causing 3 points of damage!

>n
Training Room
A place to practice jedi skills.  There is a door to the north and an exit to the south. There is a bench by the wall.

Drong is here.

Yoda is here.

Yoda attacks you with the green light sabre, causing 2 points of damage!

"wrrym"

* * *

>attack yoda with sabre
You attack Yoda with the light sabre, causing 2 points of damage!
Looks like Yoda is taking this personally.

Yoda attacks you with the green light sabre, causing 1 point of damage!

"snap"

>attack yoda with sabre
You missed Yoda
Yoda attacks you with the green light sabre, causing 4 points of damage!

>attack yoda with sabre
You attack Yoda with the light sabre, causing 4 points of damage!

Yoda attacks you with the green light sabre, causing 4 points of damage!

* * *

>test table
(Testing.)

>[1] open left drawer
You open the left drawer, revealing a light sabre.

>[2] open right drawer
You open the right drawer, revealing a D battery.

>[3] get d battery
Taken.

>[4] get sabre
Taken.

>[5] put battery in sabre
(the D battery in the light sabre)
(first opening the light sabre)
(then closing the light sabre's battery compartment)

>press button'
You can't see any such thing.

>hit yoda with sabre
Ooh I think this is a mistake.
You missed Yoda

* * *

>test table
(Testing.)

>[1] open left drawer
You open the left drawer, revealing a light sabre.

>[2] open right drawer
You open the right drawer, revealing a D battery.

>[3] get d battery
Taken.

>[4] get sabre
Taken.

>[5] put battery in sabre
(the D battery in the light sabre)
(first opening the light sabre)
(then closing the light sabre's battery compartment)

>spar with yoda
(with the light sabre)
The sabre is not on.

>press button
It is now on.

>spar with yoda
(with the light sabre)
Yoda easilly evades your reach.
Yoda says "Always in motion is the future."

"wrrym"

>attack yoda with sabre
Ooh I think this is a mistake.
You attack Yoda with the light sabre, causing 7 points of damage!

"pop"

>spar with yoda
(with the light sabre)
Yoda is not inclined to spar with you.

>attack yoda with sabre
If you are very lucky you'll live long enough to regret this.
You attack Yoda with the light sabre, causing 2 points of damage!

Yoda attacks you with the green light sabre, causing 0 points of damage!

>attack yoda with sabre
You attack Yoda with the light sabre, causing 10 points of damage!

Yoda attacks you with the green light sabre, causing 3 points of damage!

>attack yoda with sabre
You missed Yoda
Yoda attacks you with the green light sabre, causing 1 point of damage!

>attack yoda with sabre
You attack Yoda with the light sabre, causing 3 points of damage!

Yoda attacks you with the green light sabre, causing 2 points of damage!

>attack yoda with sabre
You attack Yoda with the light sabre, causing 1 point of damage!

Looks like Yoda is taking this personally.

Yoda attacks you with the green light sabre, causing 4 points of damage!

>attack yoda with sabre
You attack Yoda with the light sabre, causing 4 points of damage!

Looks like Yoda is taking this personally.

Yoda attacks you with the green light sabre, causing 3 points of damage!

"pop"

>attack yoda with sabre
You attack Yoda with the light sabre, causing 4 points of damage!

Looks like Yoda is taking this personally.

Yoda attacks you with the green light sabre, causing 4 points of damage!

>attack yoda with sabre
You attack Yoda with the light sabre, causing 10 points of damage!

Yoda attacks you with the green light sabre, causing 2 points of damage!

>attack yoda with sabre
You attack Yoda with the light sabre, causing 3 points of damage!

Looks like Yoda is taking this personally.

Yoda attacks you with the green light sabre, causing 1 point of damage!

"vrrrm"

>attack yoda with sabre
You attack Yoda with the light sabre, causing 9 points of damage!

Looks like Yoda is taking this personally.

Yoda attacks you with the green light sabre, causing 4 points of damage!

"pop"

>attack yoda with sabre
You attack Yoda with the light sabre, causing 5 points of damage!

Yoda attacks you with the green light sabre, causing 2 points of damage!

"crackle"

>attack yoda with sabre
You missed Yoda
Yoda attacks you with the green light sabre, causing 1 point of damage!

>attack yoda with sabre
You attack Yoda with the light sabre, causing 3 points of damage!

Yoda attacks you with the green light sabre, causing 1 point of damage!

>attack yoda with sabre
You missed Yoda
Looks like Yoda is taking this personally.

Yoda attacks you with the green light sabre, causing 1 point of damage!

"vrrrm"

>attack yoda with sabre
You missed Yoda
Looks like Yoda is taking this personally.

Yoda attacks you with the green light sabre, finishing you off!

    *** The End ***

In that game you scored 0 out of a possible 0, in 25 turns.

Would you like to RESTART, RESTORE a saved game, QUIT or UNDO the last command?

* * *

>test table
(Testing.)

>[1] open left drawer
You open the left drawer, revealing a light sabre.

>[2] open right drawer
You open the right drawer, revealing a D battery.

>[3] get d battery
Taken.

>[4] get sabre
Taken.

>[5] put battery in sabre
(the D battery in the light sabre)
(first opening the light sabre)
(then closing the light sabre's battery compartment)

>s
Darkness
It is pitch dark, and you can't see a thing.

>n
Training Room
A place to practice jedi skills.  There is a door to the north and an exit to the south. There is a bench by the wall.

Drong is here.

Yoda is here.

The clone warrior arrives from the south.

The bounty hunter arrives from the south.

* * *

>n
Training Room
A place to practice jedi skills.  There is a door to the north and an exit to the south. There is a bench by the wall.

Drong is here.

Yoda is here.

>press button
It is now on.

>s
Arena
Sand, blood, iron. These festivals are normally held on hot days, but the sun has gone behind a cloud and fat drops of rain now and then spatter the arena floor.

A clone warrior faces you, wielding a laser rifle and a clone blaster.

A bounty hunter circles you, pointing a shock rifle and a bounty blaster.

The clone warrior attacks you with the laser rifle, causing 1 point of damage!

The bounty hunter attacks you with the bounty blaster, causing 5 points of damage!

"pop"

>n
Training Room
A place to practice jedi skills.  There is a door to the north and an exit to the south. There is a bench by the wall.

Drong is here.

Yoda is here.

"vrrrm"

>s
Arena
Sand, blood, iron. These festivals are normally held on hot days, but the sun has gone behind a cloud and fat drops of rain now and then spatter the arena floor.

A clone warrior faces you, wielding a laser rifle and a clone blaster.

A bounty hunter circles you, pointing a shock rifle and a bounty blaster.

The clone warrior attacks you with the clone blaster, causing 4 points of damage!

Looks like the bounty hunter is taking this personally.

The bounty hunter attacks you with the shock rifle, causing 0 points of damage!

>n
Training Room
A place to practice jedi skills.  There is a door to the north and an exit to the south. There is a bench by the wall.

Drong is here.

Yoda is here.

The bounty hunter arrives from the south.

>attack bounty hunter with sabre
You attack the bounty hunter with the light sabre, causing 7 points of damage!

The bounty hunter attacks you with the bounty blaster, causing 4 points of damage!

Drong attacks the bounty hunter with the blue light sabre, causing 5 points of damage!

Yoda attacks the bounty hunter with the green light sabre, causing 1 point of damage!

"wrrym"

>attack bounty hunter with sabre
You attack the bounty hunter with the light sabre, causing 1 point of damage!

The bounty hunter attacks Drong with the shock rifle, causing 4 points of damage!

Drong attacked the bounty hunter with the blue light sabre, killing the bounty hunter!

* * *

>test table
(Testing.)

>[1] open left drawer
You open the left drawer, revealing a light sabre.

>[2] open right drawer
You open the right drawer, revealing a D battery.

>[3] get d battery
Taken.

>[4] get sabre
Taken.

>[5] put battery in sabre
(the D battery in the light sabre)
(first opening the light sabre)
(then closing the light sabre's battery compartment)

>turn on sabre
It is now on.

>spar with yoda
(with the light sabre)
Yoda side steps your clumsy maneuver.
Yoda says "Secret, shall I tell you?  Grand Master of Jedi Order am I. Won this job in a raffle I did, think you? "How did you know, how did you know, Master Yoda?" Master Yoda knows these things. His job it is."

Your experience points increases by 7.

>spar with yoda
(with the light sabre)
Yoda strikes like a viper while seeming to hover outside your range.
Yoda says "Yes, a Jedi's strength flows from the Force. But beware of the dark side. Anger, fear, aggression; the dark side of the Force are they. Easily they flow, quick to join you in a fight. If once you start down the dark path, forever will it dominate your destiny, consume you it will, as it did Obi-Wan's apprentice."

Your experience points increases by 1.  
"hrrrm"

>spar with yoda
(with the light sabre)
Yoda side steps your clumsy maneuver.
Yoda says "Always pass on what you have learned."

Your experience points increases by 6.  
"crackle"

>spar with yoda
(with the light sabre)
Yoda easilly evades your reach.
Yoda says "Through the Force, things you will see. Other places. The future...the past. Old friends long gone. "

Your experience points increases by 4.

>spar with drong
(with the light sabre)
Drong drops under your blow and suggests you loosen your grip.
Your experience points increases by 0.  
"pop"

>spar with drong
(with the light sabre)
Drong blocks your advance then tells you to trust the force.
Your experience points increases by 0.

>spar with drong
(with the light sabre)
Drong paries your thrust with a smile and a playful kick in the ass.
Your experience points increases by 0.  
"pop"

>spar with yoda
(with the light sabre)
Yoda side steps your clumsy maneuver.
Yoda says "Through the Force, things you will see. Other places. The future...the past. Old friends long gone. "

Your experience points increases by 7.

>spar with yoda
(with the light sabre)
Yoda performs an elegant backflip to avoid your well aimed stroke.
Yoda says "To answer power with power, the Jedi way this is not. In this war, a danger there is, of losing who we are."

Your experience points increases by 6.

>spar with yoda
(with the light sabre)
Yoda side steps your clumsy maneuver.
Yoda says "Secret, shall I tell you?  Grand Master of Jedi Order am I. Won this job in a raffle I did, think you? "How did you know, how did you know, Master Yoda?" Master Yoda knows these things. His job it is."

Your experience points increases by 5.

>spar with yoda
(with the light sabre)
Yoda strikes like a viper while seeming to hover outside your range.
Yoda says "A Jedi must have the deepest commitment, the most serious mind. "

Your experience points increases by 2.  
"wrrym"

>spar with yoda
(with the light sabre)
Yoda side steps your clumsy maneuver.
Yoda says "Always two there are, a master and an apprentice."

Your experience points increases by 2.  Yoda says "You're training is now complete!".  The force feels stronger in you now.  Drong will be you new padawan, Master Keav
"snap"

>look
Training Room
A place to practice jedi skills.  There is a door to the north and an exit to the south. There is a bench by the wall.

Drong is here.

Yoda is here.

>n
closet
This is a dead end. You'll have to go back the way you came.

Drong arrives from the south.

"vrrrm"

>s
Training Room
A place to practice jedi skills.  There is a door to the north and an exit to the south. There is a bench by the wall.

Yoda is here.

Drong arrives from the north.

>s
Arena
Sand, blood, iron. These festivals are normally held on hot days, but the sun has gone behind a cloud and fat drops of rain now and then spatter the arena floor.

A clone warrior faces you, wielding a laser rifle and a clone blaster.

A bounty hunter circles you, pointing a shock rifle and a bounty blaster.

Looks like the clone warrior is taking this personally.

The clone warrior attacks you with the clone blaster, causing 0 points of damage!

Looks like the bounty hunter is taking this personally.

The bounty hunter attacks you with the bounty blaster, causing 3 points of damage!

Drong arrives from the north.

>kill bounty hunter
(with the light sabre)
You attack the bounty hunter with the light sabre, causing 15 points of damage!

Drong attacks the clone warrior with the blue light sabre, causing 12 points of damage!

The clone warrior attacks Drong with the laser rifle, causing 4 points of damage!

The bounty hunter attacks Drong with the bounty blaster, causing 5 points of damage!

>kill bounty hunter
(with the light sabre)
You attack with the light sabre, killing the bounty hunter!

Drong attacks the clone warrior with the blue light sabre, causing 6 points of damage!

The clone warrior attacks Drong with the laser rifle, causing 0 points of damage!

>n
Training Room
A place to practice jedi skills.  There is a door to the north and an exit to the south. There is a bench by the wall.

Yoda is here.

Drong arrives from the south.

The clone warrior arrives from the south.

"crackle"

>kill clone warrior
(with the light sabre)
You attack with the light sabre, killing the clone warrior!

>s
Arena
Sand, blood, iron. These festivals are normally held on hot days, but the sun has gone behind a cloud and fat drops of rain now and then spatter the arena floor.

You can see a bounty blaster and a shock rifle here.

Drong arrives from the north.

>n
Training Room
A place to practice jedi skills.  There is a door to the north and an exit to the south. There is a bench by the wall.

Yoda is here.

You can also see a clone blaster and a laser rifle here.

Drong arrives from the south.

"pop"

>get clone blaster
Taken.

>drong, get laser rifle
Drong picks up the laser rifle.

>n
closet
This is a dead end. You'll have to go back the way you came.

Drong arrives from the south.

"hrrrm"

>s
Training Room
A place to practice jedi skills.  There is a door to the north and an exit to the south. There is a bench by the wall.

Yoda is here.

Drong arrives from the north.

"wrrym"

>s
Arena
Sand, blood, iron. These festivals are normally held on hot days, but the sun has gone behind a cloud and fat drops of rain now and then spatter the arena floor.

You can see a bounty blaster and a shock rifle here.

Drong arrives from the north.

"snap"

>get bounty blaster and shock rifle
bounty blaster: Taken.
shock rifle: Taken.

>look
Arena
Sand, blood, iron. These festivals are normally held on hot days, but the sun has gone behind a cloud and fat drops of rain now and then spatter the arena floor.

Drong is here.