StarWords
An Interactive Fiction by Campbell Burgess
Release 1 / Serial number 130910 / Inform 7 build 6G60 (I6/v6.32 lib 6/12N) SD

Training Room
A place to practice jedi skills.  There is a door to the north and an exit to the south. There is a bench by the wall.

Drong is here.

Yoda is here.

>look
Training Room
A place to practice jedi skills.  There is a door to the north and an exit to the south. There is a bench by the wall.

Yoda is here.

Drong is here.

>look
Training Room
A place to practice jedi skills.  There is a door to the north and an exit to the south. There is a bench by the wall.

Yoda is here.

Drong is here.

>look
Training Room
A place to practice jedi skills.  There is a door to the north and an exit to the south. There is a bench by the wall.

Yoda is here.

Drong is here.

Yoda says "Secret, shall I tell you?  Grand Master of Jedi Order am I. Won this job in a raffle I did, think you? "How did you know, how did you know, Master Yoda?" Master Yoda knows these things. His job it is."

>look
Training Room
A place to practice jedi skills.  There is a door to the north and an exit to the south. There is a bench by the wall.

Yoda is here.

Drong is here.

>look
Training Room
A place to practice jedi skills.  There is a door to the north and an exit to the south. There is a bench by the wall.

Yoda is here.

Drong is here.

Yoda says "When you look at the dark side, careful you must be. For the dark side looks back."

* * *

StarWords
An Interactive Fiction by Campbell Burgess
Release 1 / Serial number 130910 / Inform 7 build 6G60 (I6/v6.32 lib 6/12N) SD

Training Room
A place to practice jedi skills.  There is a door to the north and an exit to the south. There is a bench by the wall.

Drong is here.

Yoda is here.

>relatoins
That's not a verb I recognise.

>relations
Ally relates people to each other:
  Yoda  <=>  yourself
  Drong  <=>  yourself
  Drong  <=>  Yoda
  The bounty hunter  <=>  the clone warrior
Enemy relates people to each other:
  The clone warrior  <=>  yourself
  The clone warrior  <=>  Yoda
  The clone warrior  <=>  Drong
  The bounty hunter  <=>  yourself
  The bounty hunter  <=>  Yoda
  The bounty hunter  <=>  Drong

* * *

StarWords
An Interactive Fiction by Campbell Burgess
Release 1 / Serial number 130910 / Inform 7 build 6G60 (I6/v6.32 lib 6/12N) SD

Training Room
A place to practice jedi skills.  There is a door to the north and an exit to the south. There is a bench by the wall.

Drong is here.

Yoda is here.

>s
Darkness
It is pitch dark, and you can't see a thing.

* * *

StarWords
An Interactive Fiction by Campbell Burgess
Release 1 / Serial number 130910 / Inform 7 build 6G60 (I6/v6.32 lib 6/12N) SD

Training Room
A place to practice jedi skills.  There is a door to the north and an exit to the south. There is a bench by the wall.

Drong is here.

Yoda is here.

>test table
(Testing.)

>[1] open left drawer
You open the left drawer, revealing a light sabre.

>[2] open right drawer
You open the right drawer, revealing a D battery.

>[3] get d battery
Taken.

>[4] get sabre
Taken.

>[5] put battery in sabre
(the D battery in the light sabre)
(first opening the light sabre)
(then closing the light sabre's battery compartment)

>press button
It is now on.

"snap"

>s
Arena
Sand, blood, iron. These festivals are normally held on hot days, but the sun has gone behind a cloud and fat drops of rain now and then spatter the arena floor.

A clone warrior faces you, wielding a laser rifle and a clone blaster.

A bounty hunter circles you, pointing a shock rifle and a bounty blaster.

The clone warrior attacks you with the laser rifle, causing 5 points of damage!

The bounty hunter attacks you with the bounty blaster, causing 5 points of damage!

* * *

>n
Training Room
A place to practice jedi skills.  There is a door to the north and an exit to the south. There is a bench by the wall.

Drong is here.

Yoda is here.

The clone warrior arrives from the south.

The bounty hunter arrives from the south.

"wrrym"

>test spar
(Testing.)

>[1] spar with yoda with sabre
Yoda is surprised momentarilly by your feint, but recovers and suggests you loosen your grip.
Your experience points increases by 1.  
Yoda says "Yes, a Jedi's strength flows from the Force. But beware of the dark side. Anger, fear, aggression; the dark side of the Force are they. Easily they flow, quick to join you in a fight. If once you start down the dark path, forever will it dominate your destiny, consume you it will, as it did Obi-Wan's apprentice."

>[2] again
Yoda drops under your blow then tells you to trust the force.
Your experience points increases by 8.  
Yoda says "A Jedi must have the deepest commitment, the most serious mind. This one a long time have I watched. All his life has he looked away... to the future, to the horizon. Never his mind on where he was. Hmm? What he was doing. Hmph. Adventure. Heh. Excitement. Heh. A Jedi craves not these things."

>[3] again
Yoda is surprised momentarilly by your feint, but recovers with a smile and a playful kick in the ass.
Your experience points increases by 8.  

>[4] again
Yoda paries your thrust and suggests you loosen your grip.
Your experience points increases by 10.  
Yoda says "I cannot teach him. The boy has no patience."

>[5] again
Yoda drops under your blow with a smile and a playful kick in the ass.
Your experience points increases by 5.  
Yoda says "You will know ...the good from the bad… when you are calm, at peace. Passive. A Jedi uses the Force for knowledge and defense, never for attack."

>[6] s

Arena
Sand, blood, iron. These festivals are normally held on hot days, but the sun has gone behind a cloud and fat drops of rain now and then spatter the arena floor.

A clone warrior faces you, wielding a laser rifle and a clone blaster.

A bounty hunter circles you, pointing a shock rifle and a bounty blaster.

The clone warrior attacks you with the clone blaster, causing 3 points of damage!

The bounty hunter attacks you with the shock rifle, causing 1 point of damage!

>n
Training Room
A place to practice jedi skills.  There is a door to the north and an exit to the south. There is a bench by the wall.

Yoda is here.

Drong is here.

>test spar
(Testing.)

>[1] spar with yoda with sabre
Yoda paries your thrust and suggests you loosen your grip.
Your experience points increases by 1.  
Yoda says "Fear is the path to the dark side. Fear leads to anger. Anger leads to hate. Hate leads to suffering."

>[2] again
Yoda drops under your blow with a smile and a playful kick in the ass.
Your experience points increases by 4.  
Yoda says "You will find only what you bring in."

"vrrrm"
>[3] again
Yoda paries your thrust then tells you to trust the force.
Your experience points increases by 2.  

>[4] again
Yoda blocks your advance with a smile and a playful kick in the ass.
Your experience points increases by 0.  

>[5] again
Yoda drops under your blow and suggests you loosen your grip.
Your experience points increases by 4.  Yoda says "You're training is now complete!".  The force feels stronger in you now.  Drong will be you new padawan, Master Keav
"snap"
>[6] s

Arena
Sand, blood, iron. These festivals are normally held on hot days, but the sun has gone behind a cloud and fat drops of rain now and then spatter the arena floor.

A clone warrior faces you, wielding a laser rifle and a clone blaster.

A bounty hunter circles you, pointing a shock rifle and a bounty blaster.

The clone warrior attacks you with the clone blaster, causing 2 points of damage!

The bounty hunter attacks you with the shock rifle, causing 1 point of damage!

Drong arrives from the north.

>kill hunter with sabre
You attack the bounty hunter with the light sabre, causing 7 points of damage!

Drong attacks the bounty hunter with the blue light sabre, causing 2 points of damage!

The clone warrior attacks Drong with the laser rifle, causing 5 points of damage!

The bounty hunter attacks Drong with the bounty blaster, causing 5 points of damage!

"snap"

>kill hunter with sabre
You attack the bounty hunter with the light sabre, causing 9 points of damage!

Drong attacks the bounty hunter with the blue light sabre, causing 1 point of damage!

The clone warrior attacks you with the clone blaster, causing 4 points of damage!

The bounty hunter attacks you with the bounty blaster, causing 4 points of damage!

>kill hunter with sabre
You attack with the light sabre, killing the bounty hunter!

Drong attacks the clone warrior with the blue light sabre, causing 3 points of damage!

The clone warrior attacks you with the clone blaster, causing 0 points of damage!

* * *

>press button
It is now on.

"snap"

>spar with drong
(with the light sabre)
Drong is surprised momentarilly by your feint, but recovers with a smile and a playful kick in the ass.
Your experience points increases by 0.

* * *

>spar with yoda
(with the light sabre)
Yoda side steps your clumsy maneuver.
Yoda says "To answer power with power, the Jedi way this is not. In this war, a danger there is, of losing who we are."

Your experience points increases by 1.

>spar with yoda
(with the light sabre)
Yoda strikes like a viper while seeming to hover outside your range.
Yoda says "Once you start down the dark path, forever will it dominate your destiny, consume you it will."

Your experience points increases by 6.  Yoda says "You're training is now complete!".  The force feels stronger in you now.  Drong will be you new padawan, Master Keav

* * *

>test table
(Testing.)

>[1] open left drawer
You open the left drawer, revealing a light sabre.

>[2] open right drawer
You open the right drawer, revealing a D battery.

>[3] get d battery
Taken.

>[4] get sabre
Taken.

>[5] put battery in sabre
(the D battery in the light sabre)
(first opening the light sabre)
(then closing the light sabre's battery compartment)

>attack yoda with sabre
Ooh I think this is a mistake.
You missed Yoda

>attack yoda with sabre
If you are very lucky you'll live long enough to regret this.
You missed Yoda
Yoda to attack yourselfDrong to attack yourself

>relations
Ally relates people to each other:
  Drong  <=>  yourself
  Drong  <=>  Yoda
  The bounty hunter  <=>  the clone warrior
Enemy relates people to each other:
  Yoda  <=>  yourself
  The clone warrior  <=>  yourself
  The clone warrior  <=>  Yoda
  The clone warrior  <=>  Drong
  The bounty hunter  <=>  yourself
  The bounty hunter  <=>  Yoda
  The bounty hunter  <=>  Drong

* * *

StarWords
An Interactive Fiction by Campbell Burgess
Release 1 / Serial number 130910 / Inform 7 build 6G60 (I6/v6.32 lib 6/12N) SD

Training Room
A place to practice jedi skills.  There is a door to the north and an exit to the south. There is a bench by the wall.

Drong is here.

Yoda is here.

>test all
(Testing.)

>[1] test table
(Testing.)

>[2] open left drawer
You open the left drawer, revealing a light sabre.

>[3] open right drawer
You open the right drawer, revealing a D battery.

>[4] get d battery
Taken.

>[5] get sabre
Taken.

>[6] put battery in sabre
(the D battery in the light sabre)
(first opening the light sabre)
(then closing the light sabre's battery compartment)

>[7] press button
It is now on.

>[8] test spar
(Testing.)

>[9] spar with yoda with sabre
Yoda performs an elegant backflip to avoid your well aimed stroke.
Yoda says "Secret, shall I tell you?  Grand Master of Jedi Order am I. Won this job in a raffle I did, think you? "How did you know, how did you know, Master Yoda?" Master Yoda knows these things. His job it is."

Your experience points increases by 2.  
"vrrrm"
>[10] again
Yoda easilly evades your reach.
Yoda says "To answer power with power, the Jedi way this is not. In this war, a danger there is, of losing who we are."

Your experience points increases by 3.  
"wrrym"
>[11] again
Yoda strikes like a viper while seeming to hover outside your range.
Yoda says "And well you should not. For my ally in the Force. And a powerful ally it is. Life creates it, makes it grow. It's energy surrounds us and binds us. Luminous beings are we...(Yoda pinches Luke's shoulder)...not this crude matter. (a sweeping gesture) You must feel the Force around you. (gesturing) Here, between you...me...the tree...the rock...everywhere! Yes, even between this land and that ship!"

Your experience points increases by 8.  

>[12] again
Yoda easilly evades your reach.
Yoda says "You think Yoda stops teaching, just because his student does not want to hear? A teacher Yoda is. Yoda teaches like drunkards drink, like killers kill."

Your experience points increases by 3.  

>[13] again
Yoda strikes like a viper while seeming to hover outside your range.
Yoda says "Ohhh. Great warrior. Wars not make one great."

Your experience points increases by 0.  
"hrrrm"
>[14] s

Arena
Sand, blood, iron. These festivals are normally held on hot days, but the sun has gone behind a cloud and fat drops of rain now and then spatter the arena floor.

A clone warrior faces you, wielding a laser rifle and a clone blaster.

A bounty hunter circles you, pointing a shock rifle and a bounty blaster.

The clone warrior attacks you with the laser rifle, causing 7 points of damage!

The bounty hunter attacks you with the shock rifle, causing 6 points of damage!

I beg your pardon?

>n
Training Room
A place to practice jedi skills.  There is a door to the north and an exit to the south. There is a bench by the wall.

Yoda is here.

Drong is here.

"wrrym"

>attack yoda with sabre
Ooh I think this is a mistake.
You attack Yoda with the light sabre, causing 5 points of damage!

"vrrrm"

>attack yoda with sabre
If you are very lucky you'll live long enough to regret this.
You attack Yoda with the light sabre, causing 3 points of damage!

Yoda to attack yourself
"hrrrm"

>relations
Ally relates people to each other:
  Drong  <=>  yourself
  Drong  <=>  Yoda
  The bounty hunter  <=>  the clone warrior
Enemy relates people to each other:
  Yoda  <=>  yourself
  The clone warrior  <=>  yourself
  The clone warrior  <=>  Yoda
  The clone warrior  <=>  Drong
  The bounty hunter  <=>  yourself
  The bounty hunter  <=>  Yoda
  The bounty hunter  <=>  Drong

* * *

>n
Training Room
A place to practice jedi skills.  There is a door to the north and an exit to the south. There is a bench by the wall.

Yoda is here.

Drong is here.

"wrrym"

>hit yoda with sabre
Ooh I think this is a mistake.
You attack Yoda with the light sabre, causing 8 points of damage!

"snap"

>hit yoda with sabre
If you are very lucky you'll live long enough to regret this.
You attack Yoda with the light sabre, causing 3 points of damage!

>relations
Friend relates people to one person:
  You  >=>  Drong
Ally relates people to each other:
  Drong  <=>  yourself
  Drong  <=>  Yoda
  The bounty hunter  <=>  the clone warrior
Enemy relates people to each other:
  Yoda  <=>  yourself
  The clone warrior  <=>  yourself
  The clone warrior  <=>  Yoda
  The clone warrior  <=>  Drong
  The bounty hunter  <=>  yourself
  The bounty hunter  <=>  Yoda
  The bounty hunter  <=>  Drong

* * *

>n
Training Room
A place to practice jedi skills.  There is a door to the north and an exit to the south. There is a bench by the wall.

Yoda is here.

Drong is here.

>attack yoda with sabre
Ooh I think this is a mistake.
You attack Yoda with the light sabre, causing 10 points of damage!

>relation
That's not a verb I recognise.

>relations
Ally relates people to each other:
  Drong  <=>  yourself
  Drong  <=>  Yoda
  The bounty hunter  <=>  the clone warrior
Enemy relates people to each other:
  The clone warrior  <=>  yourself
  The clone warrior  <=>  Yoda
  The clone warrior  <=>  Drong
  The bounty hunter  <=>  yourself
  The bounty hunter  <=>  Yoda
  The bounty hunter  <=>  Drong

>attack yoda with sabre
If you are very lucky you'll live long enough to regret this.
You attack Yoda with the light sabre, causing 10 points of damage!

Yoda to attack yourselfDrong to attack yourself
"vrrrm"

>relations
Ally relates people to each other:
  Drong  <=>  yourself
  Drong  <=>  Yoda
  The bounty hunter  <=>  the clone warrior
Enemy relates people to each other:
  Yoda  <=>  yourself
  The clone warrior  <=>  yourself
  The clone warrior  <=>  Yoda
  The clone warrior  <=>  Drong
  The bounty hunter  <=>  yourself
  The bounty hunter  <=>  Yoda
  The bounty hunter  <=>  Drong

* * *

>n
Training Room
A place to practice jedi skills.  There is a door to the north and an exit to the south. There is a bench by the wall.

Yoda is here.

Drong is here.

>test spar
(Testing.)

>[1] spar with yoda with sabre
Yoda performs an elegant backflip to avoid your well aimed stroke.
Yoda says "Truly how wonderful the mind of a child is."

Your experience points increases by 0.  
"vrrrm"
>[2] again
Yoda side steps your clumsy maneuver.
Yoda says "Always pass on what you have learned."

Your experience points increases by 7.  
"wrrym"
>[3] again
Yoda performs an elegant backflip to avoid your well aimed stroke.
Yoda says "A Jedi must have the deepest commitment, the most serious mind. "

Your experience points increases by 5.  
"crackle"
>[4] again
Yoda side steps your clumsy maneuver.
Yoda says "Try not. Do or do not, there is no try."

Your experience points increases by 1.  

>[5] again
Yoda easilly evades your reach.
Yoda says "Death is a natural part of life. Rejoice for those around you who transform into the Force. Mourn them do not. Miss them do not. Attachment leads to jealously. The shadow of greed, that is."

Your experience points increases by 6.  

>[6] s

Arena
Sand, blood, iron. These festivals are normally held on hot days, but the sun has gone behind a cloud and fat drops of rain now and then spatter the arena floor.

A clone warrior faces you, wielding a laser rifle and a clone blaster.

A bounty hunter circles you, pointing a shock rifle and a bounty blaster.

The clone warrior attacks you with the laser rifle, causing 6 points of damage!

The bounty hunter attacks you with the shock rifle, causing 7 points of damage!

>n
Training Room
A place to practice jedi skills.  There is a door to the north and an exit to the south. There is a bench by the wall.

Yoda is here.

Drong is here.

"pop"

>test spar
(Testing.)

>[1] spar with yoda with sabre
Yoda strikes like a viper while seeming to hover outside your range.
Yoda says "Always pass on what you have learned."

Your experience points increases by 1.  

>[2] again
Yoda performs an elegant backflip to avoid your well aimed stroke.
Yoda says "Ready are you? What know you of ready? For eight hundred years have I trained Jedi. My own counsel will I keep on who is to be trained. A Jedi must have the deepest commitment, the most serious mind. This one a long time have I watched. All his life has he looked away... to the future, to the horizon. Never his mind on where he was. Hmm? What he was doing. Hmph. Adventure. Heh. Excitement. Heh. A Jedi craves not these things. You are reckless."

Your experience points increases by 4.  Yoda says "You're training is now complete!".  The force feels stronger in you now.  Drong will be you new padawan, Master Keav

>[3] again
Yoda side steps your clumsy maneuver.
Yoda says "Secret, shall I tell you?  Grand Master of Jedi Order am I. Won this job in a raffle I did, think you? "How did you know, how did you know, Master Yoda?" Master Yoda knows these things. His job it is."

>[4] again
Yoda easilly evades your reach.
Yoda says "Ohhh. Great warrior. Wars not make one great."

>[5] again
Yoda performs an elegant backflip to avoid your well aimed stroke.
Yoda says "Clear your mind must be, if you are to find the villains behind this plot."

>[6] s

Arena
Sand, blood, iron. These festivals are normally held on hot days, but the sun has gone behind a cloud and fat drops of rain now and then spatter the arena floor.

A clone warrior faces you, wielding a laser rifle and a clone blaster.

A bounty hunter circles you, pointing a shock rifle and a bounty blaster.

The clone warrior attacks you with the laser rifle, causing 0 points of damage!

The bounty hunter attacks you with the shock rifle, causing 4 points of damage!

Drong arrives from the north.

"pop"

>attack clone with sabre
(the clone warrior with the light sabre)
You attack the clone warrior with the light sabre, causing 5 points of damage!

Drong attacks the bounty hunter with the blue light sabre, causing 4 points of damage!

The clone warrior attacks Drong with the laser rifle, causing 0 points of damage!

The bounty hunter attacks Drong with the shock rifle, causing 1 point of damage!

>attack hunter with sabre
You attack the bounty hunter with the light sabre, causing 12 points of damage!

Drong attacked the bounty hunter with the blue light sabre, killing the bounty hunter!

*** Run-time problem P43: Attempt to remove the player from play.

The clone warrior attacks you with the clone blaster, finishing you off!

    *** The End ***

In that game you scored 0 out of a possible 0, in 28 turns.

Would you like to RESTART, RESTORE a saved game, QUIT or UNDO the last command?

* * *

StarWords
An Interactive Fiction by Campbell Burgess
Release 1 / Serial number 130910 / Inform 7 build 6G60 (I6/v6.32 lib 6/12N) SD

Training Room
A place to practice jedi skills.  There is a door to the north and an exit to the south. There is a bench by the wall.

Drong is here.

Yoda is here.

>test tabel
>--> The following tests are available:
'test gladiator'
'test table'
'test me'
'test first'
'test second'
'test sabre'