StarWords
An Interactive Fiction by Campbell Burgess
Release 1 / Serial number 130905 / Inform 7 build 6G60 (I6/v6.32 lib 6/12N) SD

Training Room
A place to practice jedi skills.  There is a door to the north and an exit to the south. There is a bench by the wall.

Yoda is here.

Drong is here.

>spar with yoda with sabre
You can't see any such thing.

>test table
(Testing.)

>[1] open left drawer
You open the left drawer, revealing a light sabre.

>[2] open right drawer
You open the right drawer, revealing a D battery.

>[3] get d battery
Taken.

>[4] get sabre
Taken.

>[5] put battery in sabre
(the D battery in the light sabre)
(first opening the light sabre)

You put the D battery into the light sabre's battery compartment.

* * *

>spar yoda with sabre
I didn't understand that sentence.

>spar with yoda
What do you want to spar with Yoda with?

* * *

StarWords
An Interactive Fiction by Campbell Burgess
Release 1 / Serial number 130905 / Inform 7 build 6G60 (I6/v6.32 lib 6/12N) SD

Training Room
A place to practice jedi skills.  There is a door to the north and an exit to the south. There is a bench by the wall.

Yoda is here.

Drong is here.

>spar with backpack with flashlight
You can only do that to something animate.

* * *

StarWords
An Interactive Fiction by Campbell Burgess
Release 1 / Serial number 130905 / Inform 7 build 6G60 (I6/v6.32 lib 6/12N) SD

Training Room
A place to practice jedi skills.  There is a door to the north and an exit to the south. There is a bench by the wall.

Yoda is here.

Drong is here.

>spar with backpack with backpack
You can only do that to something animate.

* * *

StarWords
An Interactive Fiction by Campbell Burgess
Release 1 / Serial number 130905 / Inform 7 build 6G60 (I6/v6.32 lib 6/12N) SD

Training Room
A place to practice jedi skills.  There is a door to the north and an exit to the south. There is a bench by the wall.

Yoda is here.

Drong is here.

>spar drong with backpack
I didn't understand that sentence.

>spar with drong with backpack
The backpack is NOT a weapon.

>spar with backpack
You can only do that to something animate.

* * *

StarWords
An Interactive Fiction by Campbell Burgess
Release 1 / Serial number 130905 / Inform 7 build 6G60 (I6/v6.32 lib 6/12N) SD

Training Room
A place to practice jedi skills.  There is a door to the north and an exit to the south. There is a bench by the wall.

Yoda is here.

Drong is here.

>test table
(Testing.)

>[1] open left drawer
You open the left drawer, revealing a light sabre.

>[2] open right drawer
You open the right drawer, revealing a D battery.

>[3] get d battery
Taken.

>[4] get sabre
Taken.

>[5] put battery in sabre
(the D battery in the light sabre)
(first opening the light sabre)

You put the D battery into the light sabre's battery compartment.

>spar with yoda with sabre
With what?

>spar with yoda with sabre
With what?

>spar with yoda with backpack
The backpack is NOT a weapon.

>spar with yoda with light sabre
With what?

>press button
It is now on.

>spar with yoda with light sabre
Yoda blocks your advance then tells you to trust the force.

>spar with yoda with light sabre
Yoda paries your thrust and suggests you loosen your grip.

>spar with yoda with light sabre
Yoda is surprised momentarilly by your feint, but recovers with a smile and a playful kick in the ass.

>spar with yoda with light sabre
Yoda drops under your blow then tells you to trust the force.

"wrrym"

>spar with yoda with light sabre
Yoda blocks your advance with a smile and a playful kick in the ass.

>spar with yoda with light sabre
Yoda drops under your blow and suggests you loosen your grip.

>spar with yoda with light sabre
Yoda is surprised momentarilly by your feint, but recovers with a smile and a playful kick in the ass.

>spar with yoda with light sabre
Yoda blocks your advance and suggests you loosen your grip.

"pop"

>spar with yoda with light sabre
Yoda is surprised momentarilly by your feint, but recovers then tells you to trust the force.

"hrrrm"

>spar with yoda with light sabre
Yoda blocks your advance and suggests you loosen your grip.

"wrrym"

>spar with yoda with light sabre
Yoda is surprised momentarilly by your feint, but recovers with a smile and a playful kick in the ass.

>spar with yoda with light sabre
Yoda paries your thrust then tells you to trust the force.

>spar with yoda with light sabre
Yoda blocks your advance with a smile and a playful kick in the ass.

>spar with yoda with light sabre
Yoda paries your thrust then tells you to trust the force.

>spar with yoda with light sabre
Yoda is surprised momentarilly by your feint, but recovers with a smile and a playful kick in the ass.

"snap"

>spar with yoda with light sabre
Yoda drops under your blow then tells you to trust the force.

>spar with yoda with light sabre
Yoda is surprised momentarilly by your feint, but recovers and suggests you loosen your grip.

>spar with yoda with light sabre
Yoda blocks your advance then tells you to trust the force.
Yoda says "You're training is now complete!".  The force feels stronger in you now.  Drong will be you new padawan, Master Keav
"wrrym"

>s
Arena
Sand, blood, iron. These festivals are normally held on hot days, but the sun has gone behind a cloud and fat drops of rain now and then spatter the arena floor.

A clone warrior faces you, wielding a laser rifle and a clone blaster.

A bounty hunter circles you, pointing a shock rifle and a bounty blaster.

The bounty hunter attacks you with the bounty blaster, causing 2 points of damage!

Drong arrives from the north.

>spar with clone with light sabre
(the clone warrior with the light sabre)
I don't think The clone warrior is going to play nice.

The clone warrior attacks you with the laser rifle, causing 4 points of damage!

The clone warrior attacks Drong with the laser rifle, causing 0 points of damage!

Drong attacks the clone warrior with the blue light sabre, causing 1 point of damage!

"pop"

>hit clone with light sabre
(the clone warrior with the light sabre)
You attack the clone warrior with the light sabre, causing 5 points of damage!

The bounty hunter attacks you with the shock rifle, causing 1 point of damage!

The clone warrior attacks Drong with the clone blaster, causing 0 points of damage!

Drong attacks the clone warrior with the blue light sabre, causing 0 points of damage!

"crackle"

>hit clone with light sabre
(the clone warrior with the light sabre)
You attack the clone warrior with the light sabre, causing 8 points of damage!

The clone warrior attacks you with the clone blaster, causing 3 points of damage!

The bounty hunter attacks Drong with the bounty blaster, causing 0 points of damage!

Drong attacks the bounty hunter with the blue light sabre, causing 3 points of damage!

>hit clone with light sabre
(the clone warrior with the light sabre)
You attack the clone warrior with the light sabre, causing 6 points of damage!

The clone warrior attacks you with the laser rifle, causing 2 points of damage!

The clone warrior attacks Drong with the clone blaster, causing 0 points of damage!

Drong attacked the clone warrior with the blue light sabre, killing the clone warrior!

"crackle"

>hit clone with light sabre\
You can only do that to something animate.

>hit clone with light sabre
You can only do that to something animate.

>look
Arena
Sand, blood, iron. These festivals are normally held on hot days, but the sun has gone behind a cloud and fat drops of rain now and then spatter the arena floor.

Drong is here.

A bounty hunter circles you, pointing a shock rifle and a bounty blaster.

You can also see a clone blaster and a laser rifle here.

The bounty hunter attacks you with the bounty blaster, causing 1 point of damage!

The bounty hunter attacks Drong with the shock rifle, causing 0 points of damage!

Drong attacks the bounty hunter with the blue light sabre, causing 5 points of damage!

"vrrrm"

>hit hunter with light sabre
You attack with the light sabre, killing the bounty hunter!

"pop"

>look
Arena
Sand, blood, iron. These festivals are normally held on hot days, but the sun has gone behind a cloud and fat drops of rain now and then spatter the arena floor.

Drong is here.

You can also see a bounty blaster, a shock rifle, a clone blaster and a laser rifle here.

* * *

>test table
(Testing.)

>[1] open left drawer
You open the left drawer, revealing a light sabre.

>[2] open right drawer
You open the right drawer, revealing a D battery.

>[3] get d battery
Taken.

>[4] get sabre
Taken.

>[5] put battery in sabre
(the D battery in the light sabre)
(first opening the light sabre)

You put the D battery into the light sabre's battery compartment.

>test sabre
(Testing.)

>[1] get sabre
You already have that.

>[2] open it
That's already open.

>[3] put battery in it
Which do you mean, the light sabre's battery compartment, the D battery, the flashlight's battery compartment or the cassette recorder's battery compartment?

>[4] press button
It is now on.

"wrrym"

>test yoda
>--> The following tests are available:
'test table'
'test me'
'test first'
'test second'
'test sabre'
'test fight'
'test all'

>test fight
(Testing.)

>[1] attack yoda with sabre
Yoda paries your thrust and suggests you loosen your grip.

"vrrrm"
>[2] again
Yoda drops under your blow then tells you to trust the force.

"crackle"
>[3] again
Yoda is surprised momentarilly by your feint, but recovers and suggests you loosen your grip.

>[4] again
Yoda paries your thrust with a smile and a playful kick in the ass.

"snap"
>[5] again
Yoda blocks your advance and suggests you loosen your grip.
Yoda says "You're training is now complete!".  The force feels stronger in you now.  Drong will be you new padawan, Master Keav
Drong is waiting patiently.

>[6] s

Arena
Sand, blood, iron. These festivals are normally held on hot days, but the sun has gone behind a cloud and fat drops of rain now and then spatter the arena floor.

A clone warrior faces you, wielding a laser rifle and a blaster.

A bounty hunter circles you, pointing a shock rifle and a bounty blaster.

The bounty hunter attacks you with the bounty blaster, causing 3 points of damage!

Drong arrives from the north.

>drong, attack hunter with padawan sabre
There is no reply.

The bounty hunter attacks you with the bounty blaster, causing 2 points of damage!

Drong is waiting patiently.

>drong, attack hunter
What do you want Drong to attack the bounty hunter with?

>drong, attack hunter with sabre
There is no reply.

The bounty hunter attacks you with the bounty blaster, causing 1 point of damage!

Drong is waiting patiently.

"pop"

>drong, try attack hunter with sabre
There is no reply.

The bounty hunter attacks you with the bounty blaster, causing 4 points of damage!

Drong is waiting patiently.

>try drong, attack hunter with sabre
You seem to want to talk to someone, but I can't see whom.

>try Drong, attack Hunter with sabre
You seem to want to talk to someone, but I can't see whom.

>Drong
That's not a verb I recognise.

>say drong
Whom do you want to say that to?

>say "attack hunter" to drong
There is no reply.

The bounty hunter attacks you with the shock rifle, causing 6 points of damage!

Drong is waiting patiently.

"crackle"

* * *

>test sabre
(Testing.)

>[1] get sabre
You already have that.

>[2] open it
That's already open.

>[3] put battery in it
Which do you mean, the light sabre's battery compartment, the D battery, the flashlight's battery compartment or the cassette recorder's battery compartment?

>[4] press button
It is now on.

"wrrym"

>test figth
>--> The following tests are available:
'test table'
'test me'
'test first'
'test second'
'test sabre'
'test fight'
'test all'

>test fight
(Testing.)

>[1] attack yoda with sabre
Yoda blocks your advance then tells you to trust the force.

>[2] again
Yoda paries your thrust with a smile and a playful kick in the ass.

"crackle"
>[3] again
Yoda is surprised momentarilly by your feint, but recovers then tells you to trust the force.

"hrrrm"
>[4] again
Yoda blocks your advance and suggests you loosen your grip.

>[5] again
Yoda paries your thrust then tells you to trust the force.
Yoda says "You're training is now complete!".  The force feels stronger in you now.  Drong will be you new padawan, Master Keav
Drong is waiting patiently.

>[6] s

Arena
Sand, blood, iron. These festivals are normally held on hot days, but the sun has gone behind a cloud and fat drops of rain now and then spatter the arena floor.

A clone warrior faces you, wielding a laser rifle and a blaster.

A bounty hunter circles you, pointing a shock rifle and a bounty blaster.

The bounty hunter attacks you with the bounty blaster, causing 1 point of damage!

Drong arrives from the north.

"wrrym"

>hit hunter with sabre
You attack the bounty hunter with the light sabre, causing 8 points of damage!

The bounty hunter attacks you with the bounty blaster, causing 4 points of damage!

The clone warrior attacks Drong with the laser rifle, causing 0 points of damage!

Drong is waiting patiently.

>again
You attack the bounty hunter with the light sabre, causing 1 point of damage!

The clone warrior attacks you with the blaster, causing 5 points of damage!

The bounty hunter attacks Drong with the shock rifle, causing 0 points of damage!

Drong is waiting patiently.

>again
You attack with the light sabre, killing the bounty hunter!

The clone warrior attacks you with the laser rifle, causing 1 point of damage!

The clone warrior attacks Drong with the blaster, causing 0 points of damage!

Drong is waiting patiently.

"hrrrm"

* * *

>test sabre
(Testing.)

>[1] get sabre
You already have that.

>[2] open it
That's already open.

>[3] put battery in it
Which do you mean, the light sabre's battery compartment, the D battery, the flashlight's battery compartment or the cassette recorder's battery compartment?

>[4] press button
It is now on.

"wrrym"

>test fight
(Testing.)

>[1] attack yoda with sabre
Yoda drops under your blow with a smile and a playful kick in the ass.

>[2] again
Yoda is surprised momentarilly by your feint, but recovers then tells you to trust the force.

"snap"
>[3] again
Yoda blocks your advance with a smile and a playful kick in the ass.

"crackle"
>[4] again
Yoda drops under your blow then tells you to trust the force.

>[5] again
Yoda blocks your advance and suggests you loosen your grip.
Yoda says "You're training is now complete!".  The force feels stronger in you now.  Drong will be you new padawan, Master Keav
Drong is waiting patiently.

"snap"
>[6] s

Arena
Sand, blood, iron. These festivals are normally held on hot days, but the sun has gone behind a cloud and fat drops of rain now and then spatter the arena floor.

A clone warrior faces you, wielding a laser rifle and a blaster.

A bounty hunter circles you, pointing a shock rifle and a bounty blaster.

The bounty hunter attacks you with the shock rifle, causing 4 points of damage!

Drong arrives from the north.

"vrrrm"

>kill hunter with sabre
You attack the bounty hunter with the light sabre, causing 6 points of damage!

The clone warrior attacks you with the laser rifle, causing 3 points of damage!

The bounty hunter attacks Drong with the bounty blaster, causing 0 points of damage!

Drong is waiting patiently.

>again
You attack with the light sabre, killing the bounty hunter!

The clone warrior attacks you with the blaster, causing 0 points of damage!

The clone warrior attacks Drong with the laser rifle, causing 0 points of damage!

Drong is waiting patiently.

>again
You can't see any such thing.

>look
Arena
Sand, blood, iron. These festivals are normally held on hot days, but the sun has gone behind a cloud and fat drops of rain now and then spatter the arena floor.

Drong is here.

A clone warrior faces you, wielding a laser rifle and a blaster.

You can also see a bounty blaster and a shock rifle here.

The clone warrior attacks you with the laser rifle, causing 1 point of damage!

The clone warrior attacks Drong with the laser rifle, causing 0 points of damage!

Drong is waiting patiently.

* * *

StarWords
An Interactive Fiction by Campbell Burgess
Release 1 / Serial number 130905 / Inform 7 build 6G60 (I6/v6.32 lib 6/12N) SD

Training Room
A place to practice jedi skills.  There is a door to the north and an exit to the south. There is a bench by the wall.

Yoda is here.

Drong is here.

>test all
(Testing.)

>[1] test table
(Testing.)

>[2] open left drawer
You open the left drawer, revealing a light sabre.

>[3] open right drawer
You open the right drawer, revealing a D battery.

>[4] get d battery
Taken.

>[5] get sabre
Taken.

>[6] put battery in sabre
(the D battery in the light sabre)
(first opening the light sabre)

You put the D battery into the light sabre's battery compartment.

>[7] test sabre
(Testing.)

>[8] get sabre
You already have that.

>[9] open it
That's already open.

>[10] put battery in it
Which do you mean, the light sabre's battery compartment, the D battery, the flashlight's battery compartment or the cassette recorder's battery compartment?

>[11] press button
It is now on.

"hrrrm"
>[12] test fight
(Testing.)

>[13] attack yoda with sabre
Yoda drops under your blow then tells you to trust the force.

>[14] again
Yoda blocks your advance with a smile and a playful kick in the ass.

"vrrrm"
>[15] again
Yoda drops under your blow and suggests you loosen your grip.

>[16] again
Yoda paries your thrust then tells you to trust the force.

"hrrrm"
>[17] again
Yoda blocks your advance and suggests you loosen your grip.
Yoda says "You're training is now complete!".  The force feels stronger in you now.  Drong will be you new padawan, Master Keav
"crackle"
>[18] s

Arena
Sand, blood, iron. These festivals are normally held on hot days, but the sun has gone behind a cloud and fat drops of rain now and then spatter the arena floor.

A clone warrior faces you, wielding a laser rifle and a clone blaster.

A bounty hunter circles you, pointing a shock rifle and a bounty blaster.

The clone warrior attacks you with the clone blaster, causing 3 points of damage!

Drong arrives from the north.

>hit clone with sabre
You attack the clone warrior with the light sabre, causing 5 points of damage!

The clone warrior attacks you with the laser rifle, causing 2 points of damage!

The bounty hunter attacks Drong with the bounty blaster, causing 0 points of damage!

Drong attacks the bounty hunter with the blue light sabre, causing 0 points of damage!

"vrrrm"

>again
You attack with the light sabre, killing the clone warrior!

The bounty hunter attacks you with the shock rifle, causing 4 points of damage!

The bounty hunter attacks Drong with the shock rifle, causing 0 points of damage!

Drong attacks the bounty hunter with the blue light sabre, causing 2 points of damage!

"hrrrm"

>again
You can't see any such thing.

>hit hunter with sabre
You attack the bounty hunter with the light sabre, causing 5 points of damage!

The bounty hunter attacks you with the shock rifle, causing 0 points of damage!

The bounty hunter attacks Drong with the bounty blaster, causing 0 points of damage!

Drong attacks the bounty hunter with the blue light sabre, causing 0 points of damage!

"pop"

>hit hunter with sabre
You attack the bounty hunter with the light sabre, causing 8 points of damage!

The bounty hunter attacks you with the bounty blaster, causing 4 points of damage!

The bounty hunter attacks Drong with the shock rifle, causing 0 points of damage!

Drong attacks the bounty hunter with the blue light sabre, causing 2 points of damage!

>diagnose hunter
The bounty hunter has 3 out of a possible 25 hit points remaining.

The bounty hunter attacks you with the shock rifle, causing 4 points of damage!

The bounty hunter attacks Drong with the bounty blaster, causing 0 points of damage!

Drong attacks the bounty hunter with the blue light sabre, causing 4 points of damage!

"hrrrm"

>diagnose hunter
You can't see any such thing.

>look
Arena
Sand, blood, iron. These festivals are normally held on hot days, but the sun has gone behind a cloud and fat drops of rain now and then spatter the arena floor.

Drong is here.

You can also see a blaster and a laser rifle here.

* * *

>hit clone with sabre
You attack the clone warrior with the light sabre, causing 5 points of damage!

The clone warrior attacks you with the laser rifle, causing 2 points of damage!

The bounty hunter attacks Drong with the bounty blaster, causing 0 points of damage!

Drong attacks the bounty hunter with the blue light sabre, causing 0 points of damage!

"vrrrm"

>x drong
You see nothing special about Drong.

The clone warrior attacks you with the blaster, causing 4 points of damage!

The bounty hunter attacks Drong with the bounty blaster, causing 0 points of damage!

Drong attacks the bounty hunter with the trainer, causing 2 points of damage!

Drong is waiting patiently.

"hrrrm"

* * *

>n
Training Room
A place to practice jedi skills.  There is a door to the north and an exit to the south. There is a bench by the wall.

Yoda is here.

Drong is here.

>x drong
You see nothing special about Drong.

* * *

>fight clone with sabre
I only understood you as far as wanting to fight the clone warrior.

>kill clone with sabre
You attack the clone warrior with the light sabre, causing 6 points of damage!

The clone warrior attacks you with the laser rifle, causing 6 points of damage!

The bounty hunter attacks Drong with the bounty blaster, causing 0 points of damage!

Drong attacks the bounty hunter with the blue light sabre, causing 5 points of damage!

"pop"

>again
You attack with the light sabre, killing the clone warrior!

The bounty hunter attacks you with the bounty blaster, causing 5 points of damage!

The bounty hunter attacks Drong with the bounty blaster, causing 0 points of damage!

Drong attacks the bounty hunter with the blue light sabre, causing 3 points of damage!

>kill hunter with sabre
You attack with the light sabre, killing the bounty hunter!

>restart
Are you sure you want to restart?

* * *

>kill clone with sabre
You attack the clone warrior with the light sabre, causing 5 points of damage!

The clone warrior attacks you with the blaster, causing 1 point of damage!

The bounty hunter attacks Drong with the bounty blaster, causing 0 points of damage!

Drong attacks the bounty hunter with the blue light sabre, causing 4 points of damage!

"crackle"

>kill hunter with sabre
You attack with the light sabre, killing the bounty hunter!

The clone warrior attacks you with the blaster, causing 0 points of damage!

The clone warrior attacks Drong with the blaster, causing 0 points of damage!

Drong attacks the clone warrior with the blue light sabre, causing 0 points of damage!

>look
Arena
Sand, blood, iron. These festivals are normally held on hot days, but the sun has gone behind a cloud and fat drops of rain now and then spatter the arena floor.

Drong is here.

A clone warrior faces you, wielding a laser rifle and a blaster.

You can also see a bounty blaster and a shock rifle here.

The clone warrior attacks you with the laser rifle, causing 6 points of damage!

The clone warrior attacks Drong with the blaster, causing 0 points of damage!

Drong attacks the clone warrior with the blue light sabre, causing 0 points of damage!

>look
Arena
Sand, blood, iron. These festivals are normally held on hot days, but the sun has gone behind a cloud and fat drops of rain now and then spatter the arena floor.

Drong is here.

A clone warrior faces you, wielding a laser rifle and a blaster.

You can also see a bounty blaster and a shock rifle here.

The clone warrior attacks you with the blaster, causing 4 points of damage!

The clone warrior attacks Drong with the laser rifle, causing 0 points of damage!

Drong attacks the clone warrior with the blue light sabre, causing 2 points of damage!

"hrrrm"

>look
Arena
Sand, blood, iron. These festivals are normally held on hot days, but the sun has gone behind a cloud and fat drops of rain now and then spatter the arena floor.

Drong is here.

A clone warrior faces you, wielding a laser rifle and a blaster.

You can also see a bounty blaster and a shock rifle here.

The clone warrior attacks you with the laser rifle, causing 3 points of damage!

The clone warrior attacks Drong with the laser rifle, causing 0 points of damage!

Drong attacks the clone warrior with the blue light sabre, causing 1 point of damage!

>look
Arena
Sand, blood, iron. These festivals are normally held on hot days, but the sun has gone behind a cloud and fat drops of rain now and then spatter the arena floor.

Drong is here.

A clone warrior faces you, wielding a laser rifle and a blaster.

You can also see a bounty blaster and a shock rifle here.

The clone warrior attacks you with the laser rifle, causing 4 points of damage!

The clone warrior attacks Drong with the laser rifle, causing 0 points of damage!

Drong attacks the clone warrior with the blue light sabre, causing 5 points of damage!

"snap"

>look
Arena
Sand, blood, iron. These festivals are normally held on hot days, but the sun has gone behind a cloud and fat drops of rain now and then spatter the arena floor.

Drong is here.

A clone warrior faces you, wielding a laser rifle and a blaster.

You can also see a bounty blaster and a shock rifle here.

The clone warrior attacks you with the blaster, causing 1 point of damage!

The clone warrior attacks Drong with the laser rifle, causing 0 points of damage!

Drong attacks the clone warrior with the blue light sabre, causing 4 points of damage!

"hrrrm"

>look
Arena
Sand, blood, iron. These festivals are normally held on hot days, but the sun has gone behind a cloud and fat drops of rain now and then spatter the arena floor.

Drong is here.

A clone warrior faces you, wielding a laser rifle and a blaster.

You can also see a bounty blaster and a shock rifle here.

The clone warrior attacks you with the blaster, causing 4 points of damage!

The clone warrior attacks Drong with the blaster, causing 0 points of damage!

Drong attacked with the blue light sabre, killing the clone warrior!

"snap"

>look
Arena
Sand, blood, iron. These festivals are normally held on hot days, but the sun has gone behind a cloud and fat drops of rain now and then spatter the arena floor.

Drong is here.

You can also see a blaster, a laser rifle, a bounty blaster and a shock rifle here.

>drong, get blaster
Which do you mean, the blaster or the bounty blaster?

>drong, get bounty blaster
Drong picks up the bounty blaster.

"snap"

>drong, get blaster
(the blaster)
Drong picks up the blaster.

>get rifle
Which do you mean, the laser rifle or the shock rifle?

>get laser rifle
Taken.

"pop"

>get shock rilfe
I only understood you as far as wanting to get the shock rifle.

>get shock rifle
Taken.

"hrrrm"

>inventory
You are carrying:
  a shock rifle
  a laser rifle
  a light sabre (providing light)
  a backpack (being worn and open)
    a flashlight
    a cassette recorder

"snap"

* * *

>spar with clone with sabre
(the clone warrior with the light sabre)
I hope they play nice.

The clone warrior attacks you with the clone blaster, causing 0 points of damage!

The clone warrior attacks Drong with the clone blaster, causing 0 points of damage!

Drong attacks the clone warrior with the blue light sabre, causing 4 points of damage!

"crackle"

* * *

>hit hunter with sabre
You attack the bounty hunter with the light sabre, causing 5 points of damage!

The bounty hunter attacks you with the shock rifle, causing 2 points of damage!

The bounty hunter attacks Drong with the shock rifle, causing 0 points of damage!

Drong attacks the bounty hunter with the Blue Light Sabre, causing 2 points of damage!

"hrrrm"

>drong, drop asbre
There is no reply.

The clone warrior attacks you with the blaster, causing 4 points of damage!

The bounty hunter attacks Drong with the bounty blaster, causing 0 points of damage!

Drong attacks the bounty hunter with the Blue Light Sabre, causing 5 points of damage!

"vrrrm"

>kill clone with sabre
You attack the clone warrior with the light sabre, causing 11 points of damage!

The bounty hunter attacks you with the shock rifle, causing 5 points of damage!

The bounty hunter attacks Drong with the bounty blaster, causing 0 points of damage!

Drong attacks the bounty hunter with the Blue Light Sabre, causing 3 points of damage!

>again
You missed the clone warrior
The clone warrior attacks you with the blaster, causing 3 points of damage!

The clone warrior attacks Drong with the blaster, causing 0 points of damage!

Drong attacks the clone warrior with the Blue Light Sabre, causing 2 points of damage!

>again
You attack the clone warrior with the light sabre, causing 7 points of damage!

The clone warrior attacks you with the blaster, causing 1 point of damage!

The bounty hunter attacks Drong with the bounty blaster, causing 0 points of damage!

Drong attacks the bounty hunter with the Blue Light Sabre, causing 4 points of damage!

"snap"

>again
You attack with the light sabre, killing the clone warrior!

The bounty hunter attacks you with the shock rifle, causing 7 points of damage!

The bounty hunter attacks Drong with the bounty blaster, causing 0 points of damage!

Drong attacks the bounty hunter with the Blue Light Sabre, causing 0 points of damage!

"crackle"

>hit hunder with sabre
You can't see any such thing.

>hit hunter with sabre
You attack with the light sabre, killing the bounty hunter!

"hrrrm"

>look
Arena
Sand, blood, iron. These festivals are normally held on hot days, but the sun has gone behind a cloud and fat drops of rain now and then spatter the arena floor.

Drong is here.

You can also see a bounty blaster, a shock rifle, a blaster and a laser rifle here.

>get all
bounty blaster: Taken.
shock rifle: Taken.
blaster: Taken.
laser rifle: Taken.
Blue Light Sabre: That seems to belong to Drong.
D battery: Taken.
flashlight: Taken.
cassette recorder: Taken.

The light sabre loses power and switches off!

It is now off.

It is now pitch dark in here!

* * *

StarWords
An Interactive Fiction by Campbell Burgess
Release 1 / Serial number 130905 / Inform 7 build 6G60 (I6/v6.32 lib 6/12N) SD

Training Room
A place to practice jedi skills.  There is a door to the north and an exit to the south. There is a bench by the wall.

Yoda is here.

Drong is here.

>spar with yoda
(with the backpack)
The backpack is NOT a weapon.

>spar with yoda with flashlight
Which do you mean, the flashlight or the flashlight's battery compartment?

>test table
(Testing.)

>[1] open left drawer
You open the left drawer, revealing a light sabre.

>[2] open right drawer
You open the right drawer, revealing a D battery.

>[3] get d battery
Taken.

>[4] get sabre
Taken.

>[5] put battery in sabre
(the D battery in the light sabre)
(first opening the light sabre)

You put the D battery into the light sabre's battery compartment.

>spar with yoda with flashlight
Which do you mean, the flashlight or the flashlight's battery compartment?

* * *

StarWords
An Interactive Fiction by Campbell Burgess
Release 1 / Serial number 130905 / Inform 7 build 6G60 (I6/v6.32 lib 6/12N) SD

Training Room
A place to practice jedi skills.  There is a door to the north and an exit to the south. There is a bench by the wall.

Yoda is here.

Drong is here.

>test tabel
>--> The following tests are available:
'test gladiator'
'test table'
'test me'
'test first'
'test second'
'test sabre'