StarWords
An Interactive Fiction by Campbell Burgess
Release 1 / Serial number 130825 / Inform 7 build 6G60 (I6/v6.32 lib 6/12N) SD

Training Room
A place to practice jedi skills.  There is a door to the north and an exit to the south

There is a bench by the wall.

Drong is here.

Yoda is here.

>s
Darkness
It is pitch dark, and you can't see a thing.

>n
Training Room
A place to practice jedi skills.  There is a door to the north and an exit to the south

There is a bench by the wall.

Drong is here.

Yoda is here.

>examine bench
It is an ordinary bench with two drawers, left and right

>open left drawer
You open the left drawer, revealing a D battery.

>take
What do you want to take?

>take battery
(the D battery)
Taken.

>open right drawer
You open the right drawer, revealing a light sabre.

>take light sabre
Taken.

>open sabre
You open the light sabre's battery compartment.

>put battery in sabre
(the D battery in the light sabre)
You put the D battery into the light sabre's battery compartment.

>close sabre
You close the light sabre's battery compartment.

>exam sabre
That's not a verb I recognise.

>examine sabre
The light sabre has a button at the hilt, and concealed compartment.

The light sabre is currently switched off.

>switch sabre on
It is now on.

>s
Arena
Sand, blood, iron. These festivals are normally held on hot days, but the sun has gone behind a cloud and fat drops of rain now and then spatter the arena floor.

A clone warrior faces you, wielding a laser rifle and a blaster.

A bounty hunter circles you, pointing a shock rifle and a bounty blaster.

The bounty hunter attacks you with the shock rifle, causing 7 points of damage!

>hit hunter
What do you want to hit the bounty hunter with?

>hit hunter with sabre
You attack the bounty hunter with the light sabre, causing 5 points of damage!

The clone warrior attacks you with the laser rifle, causing 1 point of damage!

>hit hunter with sabre
You missed the bounty hunter
The clone warrior attacks you with the laser rifle, causing 2 points of damage!

>hit hunter with sabre
You attack the bounty hunter with the light sabre, causing 5 points of damage!

The bounty hunter attacks you with the shock rifle, causing 5 points of damage!

>hit hunter with sabre
You attack the bounty hunter with the light sabre, causing 6 points of damage!

The clone warrior attacks you with the blaster, causing 2 points of damage!

>hit hunter with sabre
You missed the bounty hunter
The bounty hunter attacks you with the bounty blaster, causing 1 point of damage!

>hit hunter with sabre
You attack the bounty hunter with the light sabre, causing 1 point of damage!

The bounty hunter attacks you with the shock rifle, causing 1 point of damage!

>hit hunter with sabre
You attack with the light sabre, killing the bounty hunter!

The clone warrior attacks you with the laser rifle, causing 7 points of damage!

>n
Training Room
A place to practice jedi skills.  There is a door to the north and an exit to the south

There is a bench by the wall.

Drong is here.

Yoda is here.

>look
Training Room
A place to practice jedi skills.  There is a door to the north and an exit to the south

There is a bench by the wall.

Drong is here.

Yoda is here.

>hit drong with sabre
Drong blocks your advance then tells you to trust the force.

>hit drong with sabre
Drong drops under your blow and suggests you loosen your grip.

>hit drong with sabre
Drong is surprised momentarilly by your feint, but recovers then tells you to trust the force.

>hit yoda
What do you want to hit Yoda with?

>hit yoda with sabre
Yoda paries your thrust with a smile and a playful kick in the ass.

>hit yoda with sabre
Yoda blocks your advance then tells you to trust the force.

>hit yoda with sabre
Yoda drops under your blow and suggests you loosen your grip.

>hit yoda with sabre
Yoda paries your thrust then tells you to trust the force.

>hit yoda with sabre
Yoda blocks your advance and suggests you loosen your grip.

>hit yoda with sabre
Yoda paries your thrust then tells you to trust the force.

>hit yoda with sabre
Yoda drops under your blow with a smile and a playful kick in the ass.

>hit yoda with sabre
Yoda is surprised momentarilly by your feint, but recovers and suggests you loosen your grip.

>hit yoda with sabre
Yoda paries your thrust with a smile and a playful kick in the ass.

>hit yoda with sabre
Yoda drops under your blow and suggests you loosen your grip.

* * *

>hit yoda with sabre
Yoda paries your thrust then tells you to trust the force.

>hit yoda with sabre
Yoda is surprised momentarilly by your feint, but recovers and suggests you loosen your grip.

* * *

>hit yoda with sabre
Yoda paries your thrust with a smile and a playful kick in the ass.

>hit yoda with sabre
Yoda is surprised momentarilly by your feint, but recovers and suggests you loosen your grip.

>hit yoda with sabre
Yoda blocks your advance then tells you to trust the force.

>hit yoda with sabre
Yoda drops under your blow with a smile and a playful kick in the ass.

I beg your pardon?

>hit yoda with sabre
Yoda paries your thrust and suggests you loosen your grip.

>hit yoda with sabre
Yoda blocks your advance with a smile and a playful kick in the ass.

>hit yoda with sabre
Yoda is surprised momentarilly by your feint, but recovers then tells you to trust the force.

The light sabre is obviously going to go out quite soon.

>hit yoda with sabre
Yoda drops under your blow and suggests you loosen your grip.

>hit yoda with sabre
Yoda blocks your advance then tells you to trust the force.

The light sabre loses power and switches off!

It is now off.

>hit yoda with sabre
With what?

>hit yoda with sabre
With what?

I beg your pardon?

>hit yoda with sabre
With what?

>hit drong with sabre
With what?

>restart
Are you sure you want to restart?

* * *

>look
Training Room
A place to practice jedi skills.  There is a door to the north and an exit to the south

There is a bench by the wall.

Drong is here.

Yoda is here.

>get sabre
You can't see any such thing.

>x bench
It is an ordinary bench with two drawers, left and right

>open left drawer
You open the left drawer, revealing a D battery.

>get bettery
You can't see any such thing.

>get d
(the D battery)
Taken.

>open right drawer
You open the right drawer, revealing a light sabre.

>get sabre
Taken.

>open sabre
You open the light sabre's battery compartment.

* * *

>close sabre
You close the light sabre's battery compartment.

>turn on sabre
It is now on.

>n
Dead End
This is a dead end. You'll have to go back the way you came.

>s
Training Room
A place to practice jedi skills.  There is a door to the north and an exit to the south

There is a bench by the wall.

Drong is here.

Yoda is here.

>attack drong with sabre
Drong blocks your advance with a smile and a playful kick in the ass.

>again
Drong is surprised momentarilly by your feint, but recovers then tells you to trust the force.

>again
Drong blocks your advance with a smile and a playful kick in the ass.

>again
Drong is surprised momentarilly by your feint, but recovers then tells you to trust the force.

>again
Drong blocks your advance with a smile and a playful kick in the ass.
Drong says "You're training is now complete!".  The force feels stronger in you now.

>s
Arena
Sand, blood, iron. These festivals are normally held on hot days, but the sun has gone behind a cloud and fat drops of rain now and then spatter the arena floor.

A clone warrior faces you, wielding a laser rifle and a blaster.

A bounty hunter circles you, pointing a shock rifle and a bounty blaster.

The clone warrior attacks you with the blaster, causing 2 points of damage!

>attack clone warrior with sabre
You attack the clone warrior with the light sabre, causing 1 point of damage!

The bounty hunter attacks you with the shock rifle, causing 2 points of damage!

>attack bounty hunter with sabre
You attack the bounty hunter with the light sabre, causing 9 points of damage!

The clone warrior attacks you with the laser rifle, causing 6 points of damage!

>attack clone warrior with sabre
You attack the clone warrior with the light sabre, causing 4 points of damage!

The bounty hunter attacks you with the shock rifle, causing 1 point of damage!

>attack bounty hunter with sabre
You attack with the light sabre, killing the bounty hunter!

The clone warrior attacks you with the laser rifle, causing 4 points of damage!

>attack clone warrior with sabre
You attack the clone warrior with the light sabre, causing 10 points of damage!

The clone warrior attacks you with the blaster, causing 2 points of damage!

>again
You attack with the light sabre, killing the clone warrior!

* * *

StarWords
An Interactive Fiction by Campbell Burgess
Release 1 / Serial number 130825 / Inform 7 build 6G60 (I6/v6.32 lib 6/12N) SD

Training Room
A place to practice jedi skills.  There is a door to the north and an exit to the south

There is a bench by the wall.

Drong is here.

Yoda is here.

>x yoda
Yoda is respected as one of the most wise and powerful Jedi Masters in the history of the galaxy. Yoda is a master of the Force and Lightsaber combat. Yoda has served as the Grand Master of the Jedi High Council for over 700 years.

* * *

StarWords
An Interactive Fiction by Campbell Burgess
Release 1 / Serial number 130825 / Inform 7 build 6G60 (I6/v6.32 lib 6/12N) SD

Training Room
A place to practice jedi skills.  There is a door to the north and an exit to the south

There is a bench by the wall.

Drong is here.

Yoda is here.

>open left drawer
You open the left drawer, revealing a D battery.

>get d
(the D battery)
Taken.

* * *

>get sabre
Taken.

>open light sabre battery compartment
I only understood you as far as wanting to open the light sabre.

>open sabre
You open the light sabre's battery compartment.

* * *

>close sabre
You close the light sabre's battery compartment.

>turn sabre on
It is now on.

>s
Arena
Sand, blood, iron. These festivals are normally held on hot days, but the sun has gone behind a cloud and fat drops of rain now and then spatter the arena floor.

A clone warrior faces you, wielding a laser rifle and a blaster.

A bounty hunter circles you, pointing a shock rifle and a bounty blaster.

The clone warrior attacks you with the blaster, causing 4 points of damage!

>turn sabre off
It is now off.

It is now pitch dark in here!

>look
Darkness
It is pitch dark, and you can't see a thing.

>n
Training Room
A place to practice jedi skills.  There is a door to the north and an exit to the south

There is a bench by the wall.

Drong is here.

Yoda is here.

>turn sabre on
It is now on.

>attack drong
What do you want to attack Drong with?

>attack drong with sabre
Drong blocks your advance then tells you to trust the force.

>use force
That's not a verb I recognise.

>attack drong with force
You can't see any such thing.

>attack drong
What do you want to attack Drong with?

>attack drong with sabre
Drong is surprised momentarilly by your feint, but recovers with a smile and a playful kick in the ass.

>attack drong with sabre
Drong drops under your blow and suggests you loosen your grip.

>again
Drong is surprised momentarilly by your feint, but recovers then tells you to trust the force.

>again
Drong blocks your advance and suggests you loosen your grip.

>again
Drong paries your thrust with a smile and a playful kick in the ass.

>again
Drong drops under your blow and suggests you loosen your grip.

>again
Drong paries your thrust then tells you to trust the force.

>again
Drong blocks your advance with a smile and a playful kick in the ass.
Drong says "You're training is now complete!".  The force feels stronger in you now.

>n
Dead End
This is a dead end. You'll have to go back the way you came.

* * *

>s
Training Room
A place to practice jedi skills.  There is a door to the north and an exit to the south

There is a bench by the wall.

Drong is here.

Yoda is here.

>s
Arena
Sand, blood, iron. These festivals are normally held on hot days, but the sun has gone behind a cloud and fat drops of rain now and then spatter the arena floor.

A clone warrior faces you, wielding a laser rifle and a blaster.

A bounty hunter circles you, pointing a shock rifle and a bounty blaster.

The bounty hunter attacks you with the shock rifle, causing 4 points of damage!

>attack bounty hunter with sabre
You attack the bounty hunter with the light sabre, causing 11 points of damage!

The bounty hunter attacks you with the shock rifle, causing 7 points of damage!

>attack bounty hunter with sabre
You attack the bounty hunter with the light sabre, causing 1 point of damage!

The bounty hunter attacks you with the bounty blaster, causing 0 points of damage!

>again
You attack with the light sabre, killing the bounty hunter!

The clone warrior attacks you with the blaster, causing 4 points of damage!

>attack clone warrior with sabre
You attack the clone warrior with the light sabre, causing 7 points of damage!

The clone warrior attacks you with the laser rifle, causing 6 points of damage!

>again
You attack the clone warrior with the light sabre, causing 11 points of damage!

The clone warrior attacks you with the laser rifle, causing 7 points of damage!

>again
You attack with the light sabre, killing the clone warrior!

>look
Arena
Sand, blood, iron. These festivals are normally held on hot days, but the sun has gone behind a cloud and fat drops of rain now and then spatter the arena floor.

>restart
Are you sure you want to restart?

* * *

>get sabre
Taken.

>open battery compartment
Which do you mean, the light sabre's battery compartment, the flashlight's battery compartment or the cassette recorder's battery compartment?

>open sabre battery compartment
You can't see any such thing.

>open sabres battery compartment
You can't see any such thing.

>open the sabres battery compartment
You can't see any such thing.

>open the sabre battery compartment
You can't see any such thing.

* * *

StarWords
An Interactive Fiction by Campbell Burgess
Release 1 / Serial number 130825 / Inform 7 build 6G60 (I6/v6.32 lib 6/12N) SD

Training Room
A place to practice jedi skills.  There is a door to the north and an exit to the south

There is a bench by the wall.

Drong is here.

Yoda is here.

>test tab'e
>--> The following tests are available:
'test table'
'test me'
'test first'
'test second'
'test sabre'
'test fight'
'test all'

>test table
(Testing.)

>[1] open left drawer
You open the left drawer, revealing a D battery.

>[2] open right drawer
You open the right drawer, revealing a light sabre.

>[3] get d battery
Taken.

>[4] get sabre
Taken.

>[5] kill yoda with sabre
With what?

>test sabre
(Testing.)

>[1] get sabre
You already have that.

>[2] open it
You open the light sabre's battery compartment.

>[3] put battery in it
(the D battery in the light sabre)
You put the D battery into the light sabre's battery compartment.

>[4] press button
It is now on.

>test fight
(Testing.)

>[1] attack yoda with sabre
Yoda drops under your blow then tells you to trust the force.

>[2] again
Yoda paries your thrust with a smile and a playful kick in the ass.

>[3] again
Yoda is surprised momentarilly by your feint, but recovers and suggests you loosen your grip.

>[4] again
Yoda drops under your blow with a smile and a playful kick in the ass.

>[5] again
Yoda is surprised momentarilly by your feint, but recovers then tells you to trust the force.
Yoda says "You're training is now complete!".  The force feels stronger in you now.

>[6] s

Arena
Sand, blood, iron. These festivals are normally held on hot days, but the sun has gone behind a cloud and fat drops of rain now and then spatter the arena floor.

A clone warrior faces you, wielding a laser rifle and a blaster.

A bounty hunter circles you, pointing a shock rifle and a bounty blaster.

The clone warrior attacks you with the laser rifle, causing 0 points of damage!

The bounty hunter attacks you with the shock rifle, causing 0 points of damage!

>again
You can't go that way.

The clone warrior attacks you with the blaster, causing 0 points of damage!

The bounty hunter attacks you with the shock rifle, causing 0 points of damage!

* * *

StarWords
An Interactive Fiction by Campbell Burgess
Release 1 / Serial number 130825 / Inform 7 build 6G60 (I6/v6.32 lib 6/12N) SD

Training Room
A place to practice jedi skills.  There is a door to the north and an exit to the south

There is a bench by the wall.

Drong is here.

Yoda is here.

>test table
(Testing.)

>[1] open left drawer
You open the left drawer, revealing a D battery.

>[2] open right drawer
You open the right drawer, revealing a light sabre.

>[3] get d battery
Taken.

>[4] get sabre
Taken.

>[5] kill yoda with sabre
With what?

* * *

>test sabre
(Testing.)

>[1] get sabre
You already have that.

>[2] open it
You open the light sabre's battery compartment.

>[3] put battery in it
(the D battery in the light sabre)
You put the D battery into the light sabre's battery compartment.

>[4] press button
It is now on.

>kill yoda with sabre
Yoda drops under your blow and suggests you loosen your grip.

>kill yoda with sabre
Yoda is surprised momentarilly by your feint, but recovers with a smile and a playful kick in the ass.

>kill yoda with sabre
Yoda paries your thrust and suggests you loosen your grip.

>kill yoda with sabre
Yoda drops under your blow with a smile and a playful kick in the ass.

>kill yoda with sabre
Yoda is surprised momentarilly by your feint, but recovers and suggests you loosen your grip.
Yoda says "You're training is now complete!".  The force feels stronger in you now.

>s
Arena
Sand, blood, iron. These festivals are normally held on hot days, but the sun has gone behind a cloud and fat drops of rain now and then spatter the arena floor.

A clone warrior faces you, wielding a laser rifle and a blaster.

A bounty hunter circles you, pointing a shock rifle and a bounty blaster.

The clone warrior attacks you with the laser rifle, causing 1 point of damage!

>hit hunter with sabre
You attack the bounty hunter with the light sabre, causing 18 points of damage!

The bounty hunter attacks you with the shock rifle, causing 0 points of damage!

>hit hunter with sabre
You attack with the light sabre, killing the bounty hunter!

The clone warrior attacks you with the blaster, causing 3 points of damage!

>hit warrior with sabre
You attack the clone warrior with the light sabre, causing 11 points of damage!

The clone warrior attacks you with the laser rifle, causing 2 points of damage!

I beg your pardon?

>hit warrior with sabre
You attack with the light sabre, killing the clone warrior!

>look
Arena
Sand, blood, iron. These festivals are normally held on hot days, but the sun has gone behind a cloud and fat drops of rain now and then spatter the arena floor.

>n
Training Room
A place to practice jedi skills.  There is a door to the north and an exit to the south

There is a bench by the wall.

Drong is here.

Yoda is here.

>open door
You can't see any such thing.

>n
Dead End
This is a dead end. You'll have to go back the way you came.

* * *

>s
Training Room
A place to practice jedi skills.  There is a door to the north and an exit to the south

There is a bench by the wall.

Drong is here.

Yoda is here.

>press button
It is now off.

>s
Darkness
It is pitch dark, and you can't see a thing.

* * *

>n
Training Room
A place to practice jedi skills.  There is a door to the north and an exit to the south

There is a bench by the wall.

Drong is here.

Yoda is here.

>n
Darkness
It is pitch dark, and you can't see a thing.

I beg your pardon?

* * *

StarWords
An Interactive Fiction by Campbell Burgess
Release 1 / Serial number 130825 / Inform 7 build 6G60 (I6/v6.32 lib 6/12N) SD

Training Room
A place to practice jedi skills.  There is a door to the north and an exit to the south

There is a bench by the wall.

Drong is here.

Yoda is here.

>test all
(Testing.)

>[1] test table
(Testing.)

>[2] open left drawer
You open the left drawer, revealing a D battery.

>[3] open right drawer
You open the right drawer, revealing a light sabre.

>[4] get d battery
Taken.

>[5] get sabre
Taken.

>[6] kill yoda with sabre
With what?

>[7] test sabre
(Testing.)

>[8] get sabre
You already have that.

>[9] open it
You open the light sabre's battery compartment.

>[10] put battery in it
(the D battery in the light sabre)
You put the D battery into the light sabre's battery compartment.

>[11] press button
It is now on.

>[12] test fight
(Testing.)

>[13] attack yoda with sabre
Yoda paries your thrust with a smile and a playful kick in the ass.

"crackle"
>[14] again
Yoda is surprised momentarilly by your feint, but recovers then tells you to trust the force.

"hrrrm"
>[15] again
Yoda blocks your advance and suggests you loosen your grip.

>[16] again
Yoda is surprised momentarilly by your feint, but recovers then tells you to trust the force.

>[17] again
Yoda paries your thrust and suggests you loosen your grip.
Yoda says "You're training is now complete!".  The force feels stronger in you now.

"hrrrm"
>[18] s

Arena
Sand, blood, iron. These festivals are normally held on hot days, but the sun has gone behind a cloud and fat drops of rain now and then spatter the arena floor.

A clone warrior faces you, wielding a laser rifle and a blaster.

A bounty hunter circles you, pointing a shock rifle and a bounty blaster.

The clone warrior attacks you with the laser rifle, causing 2 points of damage!

>n
Training Room
A place to practice jedi skills.  There is a door to the north and an exit to the south

There is a bench by the wall.

Drong is here.

Yoda is here.

hrrrm

>attack yoda with sabre
Yoda is surprised momentarilly by your feint, but recovers and suggests you loosen your grip.

>attack yoda with sabre
Yoda paries your thrust with a smile and a playful kick in the ass.

>attack yoda with sabre
Yoda is surprised momentarilly by your feint, but recovers and suggests you loosen your grip.

>attack yoda with sabre
Yoda drops under your blow then tells you to trust the force.

>attack yoda with sabre
Yoda is surprised momentarilly by your feint, but recovers and suggests you loosen your grip.

* * *

>attack yoda with sabre
Yoda paries your thrust with a smile and a playful kick in the ass.

>attack yoda with sabre
Yoda is surprised momentarilly by your feint, but recovers then tells you to trust the force.

>attack yoda with sabre
Yoda paries your thrust and suggests you loosen your grip.

>attack yoda with sabre
Yoda is surprised momentarilly by your feint, but recovers with a smile and a playful kick in the ass.

>attack yoda with sabre
Yoda drops under your blow then tells you to trust the force.

>s
Arena
Sand, blood, iron. These festivals are normally held on hot days, but the sun has gone behind a cloud and fat drops of rain now and then spatter the arena floor.

A clone warrior faces you, wielding a laser rifle and a blaster.

A bounty hunter circles you, pointing a shock rifle and a bounty blaster.

The clone warrior attacks you with the laser rifle, causing 0 points of damage!

>kill clone with sabre
You attack the clone warrior with the light sabre, causing 20 points of damage!

The bounty hunter attacks you with the shock rifle, causing 4 points of damage!

>kill clone with sabre
You attack with the light sabre, killing the clone warrior!

The bounty hunter attacks you with the bounty blaster, causing 3 points of damage!

>kill clone with sabre
You can't see any such thing.

>kill hunter with sabre
You attack the bounty hunter with the light sabre, causing 7 points of damage!

The bounty hunter attacks you with the shock rifle, causing 4 points of damage!

>kill hunter with sabre
You attack the bounty hunter with the light sabre, causing 9 points of damage!

The bounty hunter attacks you with the bounty blaster, causing 0 points of damage!

I beg your pardon?

>kill hunter with sabre
You missed the bounty hunter
The bounty hunter attacks you with the bounty blaster, causing 0 points of damage!

>kill hunter with sabre
You attack with the light sabre, killing the bounty hunter!

>kill hunter with sabre
You can't see any such thing.

>look
Arena
Sand, blood, iron. These festivals are normally held on hot days, but the sun has gone behind a cloud and fat drops of rain now and then spatter the arena floor.

* * *

>n
Training Room
A place to practice jedi skills.  There is a door to the north and an exit to the south

There is a bench by the wall.

Drong is here.

Yoda is here.

hrrrm

>press button
It is now off.

>press button
It is now on.

vrrrm

* * *

>kill clone with sabre
You attack the clone warrior with the light sabre, causing 2 points of damage!

The bounty hunter attacks you with the bounty blaster, causing 3 points of damage!

"hrrrm"

>kill clone with sabre
You attack the clone warrior with the light sabre, causing 18 points of damage!

The bounty hunter attacks you with the shock rifle, causing 6 points of damage!

>kill clone with sabre
You attack with the light sabre, killing the clone warrior!

The bounty hunter attacks you with the bounty blaster, causing 5 points of damage!

"crackle"

>kill clone with sabre
You can't see any such thing.

>kill hunter with sabre
You attack the bounty hunter with the light sabre, causing 20 points of damage!

The bounty hunter attacks you with the bounty blaster, causing 0 points of damage!

"vrrrm"

>kill hunter with sabre
You attack with the light sabre, killing the bounty hunter!

* * *

>kill clone with sabre
You attack with the light sabre, killing the clone warrior!

The bounty hunter attacks you with the bounty blaster, causing 5 points of damage!

"crackle"

>kill hunter with sabre
You attack the bounty hunter with the light sabre, causing 5 points of damage!

The bounty hunter attacks you with the shock rifle, causing 3 points of damage!

"snap"

>kill hunter with sabre
You attack the bounty hunter with the light sabre, causing 12 points of damage!

The bounty hunter attacks you with the shock rifle, causing 6 points of damage!

"vrrrm"

>kill hunter with sabre
You attack with the light sabre, killing the bounty hunter!

>z
Time passes.

"snap"

>z
Time passes.

"hrrrm"

>z
Time passes.

>z
Time passes.

"pop"

>z
Time passes.

>z
Time passes.

"vrrrm"

>z
Time passes.

"wrrym"

>z
Time passes.

"pop"

* * *

>z
Time passes.

>z
Time passes.

"wrrym"

>z
Time passes.

>z
Time passes.

"crackle"

>z
Time passes.

"snap"

>z
Time passes.

>z
Time passes.

* * *

StarWords
An Interactive Fiction by Campbell Burgess
Release 1 / Serial number 130825 / Inform 7 build 6G60 (I6/v6.32 lib 6/12N) SD

Training Room
A place to practice jedi skills.  There is a door to the north and an exit to the south

There is a bench by the wall.

Drong is here.

Yoda is here.

>n
Darkness
It is pitch dark, and you can't see a thing.

the arena is dark

>s
training room
A place to practice jedi skills.  There is a door to the north and an exit to the south

There is a bench by the wall.

Drong is here.

Yoda is here.

the arena is dark

>test tabel
>--> The following tests are available:
'test gladiator'
'test table'
'test me'
'test first'
'test second'
'test sabre'

>test table
(Testing.)

>[1] open left drawer
You open the left drawer, revealing a D battery.

the arena is dark
>[2] open right drawer
You open the right drawer, revealing a light sabre.

the arena is dark
>[3] get d battery
Taken.

the arena is dark
>[4] get sabre
Taken.

the arena is dark
>[5] kill yoda with sabre
With what?

the arena is dark

>test sabre
(Testing.)

>[1] get sabre
You already have that.

the arena is dark
>[2] open it
You open the light sabre's battery compartment.

the arena is dark
>[3] put battery in it
(the D battery in the light sabre)
You put the D battery into the light sabre's battery compartment.

the arena is dark

>press button
It is now on.

the arena is dark

>s
Arena
Sand, blood, iron. These festivals are normally held on hot days, but the sun has gone behind a cloud and fat drops of rain now and then spatter the arena floor.

A clone warrior faces you, wielding a laser rifle and a blaster.

A bounty hunter circles you, pointing a shock rifle and a bounty blaster.

the arena is dark

* * *

StarWords
An Interactive Fiction by Campbell Burgess
Release 1 / Serial number 130825 / Inform 7 build 6G60 (I6/v6.32 lib 6/12N) SD

Training Room
A place to practice jedi skills.  There is a door to the north and an exit to the south

There is a bench by the wall.

Drong is here.

Yoda is here.

>test tabe
>--> The following tests are available:
'test table'
'test me'
'test first'
'test second'
'test sabre'
'test fight'
'test all'

>test table
(Testing.)

>[1] open left drawer
You open the left drawer, revealing a D battery.

>[2] open right drawer
You open the right drawer, revealing a light sabre.

>[3] get d battery
Taken.

>[4] get sabre
Taken.

>[5] kill yoda with sabre
With what?

* * *

>test sabre
(Testing.)

>[1] get sabre
You already have that.

>[2] open it
You open the light sabre's battery compartment.

>[3] put battery in it
(the D battery in the light sabre)
You put the D battery into the light sabre's battery compartment.

>[4] press button
It is now on.

>kill clone with sabre
You can't see any such thing.

>s
Arena
Sand, blood, iron. These festivals are normally held on hot days, but the sun has gone behind a cloud and fat drops of rain now and then spatter the arena floor.

A clone warrior faces you, wielding a laser rifle and a blaster.

A bounty hunter circles you, pointing a shock rifle and a bounty blaster.

The clone warrior attacks you with the laser rifle, causing 3 points of damage!

>kill yoda with sabre
You can't see any such thing.

* * *

StarWords
An Interactive Fiction by Campbell Burgess
Release 1 / Serial number 130825 / Inform 7 build 6G60 (I6/v6.32 lib 6/12N) SD

Training Room
A place to practice jedi skills.  There is a door to the north and an exit to the south

There is a bench by the wall.

Drong is here.

Yoda is here.

>test tabel
>--> The following tests are available:
'test gladiator'
'test table'
'test me'
'test first'
'test second'
'test sabre'

>test table
(Testing.)

>[1] open left drawer
You open the left drawer, revealing a D battery.

>[2] open right drawer
You open the right drawer, revealing a light sabre.

>[3] get d battery
Taken.

>[4] get sabre
Taken.

>attack yoda with sabre
You missed Yoda

* * *

StarWords
An Interactive Fiction by Campbell Burgess
Release 1 / Serial number 130825 / Inform 7 build 6G60 (I6/v6.32 lib 6/12N) SD

Training Room
A place to practice jedi skills.  There is a door to the north and an exit to the south

There is a bench by the wall.

Drong is here.

Yoda is here.

>attack the clone with hands
You can't see any such thing.

>test table
(Testing.)

>[1] open left drawer
You open the left drawer, revealing a D battery.

>[2] open right drawer
You open the right drawer, revealing a light sabre.

>[3] get d battery
Taken.

>[4] get sabre
Taken.

>[5] kill yoda with sabre
With what?

* * *

>test sabre
(Testing.)

>[1] get sabre
You already have that.

>[2] open it
You open the light sabre's battery compartment.

>[3] put battery in it
(the D battery in the light sabre)
You put the D battery into the light sabre's battery compartment.

>[4] press button
It is now on.

>attack the clone with sabre
You can't see any such thing.

>s
Arena
Sand, blood, iron. These festivals are normally held on hot days, but the sun has gone behind a cloud and fat drops of rain now and then spatter the arena floor.

A clone warrior faces you, wielding a laser rifle and a blaster.

A bounty hunter circles you, pointing a shock rifle and a bounty blaster.

The clone warrior attacks you with the blaster, causing 1 point of damage!

>attack the yoda with sabre
You can't see any such thing.

>kill hunter with sabre
You attack the bounty hunter with the light sabre, causing 1 point of damage!

The clone warrior attacks you with the blaster, causing 4 points of damage!

>kill hunter with sabre
You attack the bounty hunter with the light sabre, causing 8 points of damage!

The clone warrior attacks you with the blaster, causing 0 points of damage!

>kill hunter with sabre
You attack the bounty hunter with the light sabre, causing 6 points of damage!

The clone warrior attacks you with the laser rifle, causing 2 points of damage!

>kill hunter with sabre
You attack the bounty hunter with the light sabre, causing 3 points of damage!

The bounty hunter attacks you with the bounty blaster, causing 0 points of damage!

>kill hunter with sabre
You missed the bounty hunter
The clone warrior attacks you with the blaster, causing 4 points of damage!

>kill hunter with sabre
You attack with the light sabre, killing the bounty hunter!

The clone warrior attacks you with the blaster, causing 3 points of damage!

>kill clone with sabre
You attack the clone warrior with the light sabre, causing 9 points of damage!

The clone warrior attacks you with the laser rifle, causing 1 point of damage!

>kill clone with sabre
You attack the clone warrior with the light sabre, causing 3 points of damage!

The clone warrior attacks you with the laser rifle, causing 3 points of damage!

>kill clone with sabre
You attack the clone warrior with the light sabre, causing 1 point of damage!

The clone warrior attacks you with the laser rifle, causing 4 points of damage!

>kill clone with sabre
You attack the clone warrior with the light sabre, causing 6 points of damage!

The clone warrior attacks you with the blaster, causing 0 points of damage!

>kill clone with sabre
You attack the clone warrior with the light sabre, causing 1 point of damage!

The clone warrior attacks you with the blaster, causing 1 point of damage!

>kill clone with sabre
You attack with the light sabre, killing the clone warrior!

>n
training room
A place to practice jedi skills.  There is a door to the north and an exit to the south

There is a bench by the wall.

Drong is here.

Yoda is here.

>s
Arena
Sand, blood, iron. These festivals are normally held on hot days, but the sun has gone behind a cloud and fat drops of rain now and then spatter the arena floor.

>kill yoda with the sabre
You can't see any such thing.