StarWords
An Interactive Fiction by Campbell Burgess
Release 1 / Serial number 130914 / Inform 7 build 6G60 (I6/v6.32 lib 6/12N) SD

Training Room
A place to practice jedi skills.  There is a door to the north and an exit to the south. There is a bench by the wall.

Drong is here.

Yoda is here.

>yoda track me
That's not a verb I recognise.

* * *

StarWords
An Interactive Fiction by Campbell Burgess
Release 1 / Serial number 130914 / Inform 7 build 6G60 (I6/v6.32 lib 6/12N) SD

Training Room
A place to practice jedi skills.  There is a door to the north and an exit to the south. There is a bench by the wall.

Drong is here.

Yoda is here.

>test sabre
(Testing.)

>[1] get sabre
You can't see any such thing.

>[2] open it
I'm not sure what "it" refers to.

>[3] put battery in it
You can't see any such thing.

>[4] press button
You can't see any such thing.

>press button
You can't see any such thing.

>test table
(Testing.)

>[1] open left drawer
You open the left drawer, revealing a light sabre.

>[2] open right drawer
You open the right drawer, revealing a D battery.

>[3] get d battery
Taken.

>[4] get sabre
Taken.

>[5] put battery in sabre
(the D battery in the light sabre)
(first opening the light sabre)
(then closing the light sabre's battery compartment)

>press button
It is now on.

"pop"

>yoda, follow me
Yoda says "Ok, I will follow yourself."

>s
Arena
Sand, blood, iron. These festivals are normally held on hot days, but the sun has gone behind a cloud and fat drops of rain now and then spatter the arena floor.

A clone warrior faces you, wielding a laser rifle and a clone blaster.

A bounty hunter circles you, pointing a shock rifle and a bounty blaster.

The clone warrior attacks you with the laser rifle, causing 3 points of damage!

The bounty hunter attacks you with the shock rifle, causing 7 points of damage!

Yoda arrives from the north.

"wrrym"

>clone, attack bounty with rilfe
There is no reply.

Yoda attacks the clone warrior with the green light sabre, causing 6 points of damage!

The clone warrior attacks you with the laser rifle, causing 4 points of damage!

The bounty hunter attacks Yoda with the shock rifle, causing 4 points of damage!

>clone, attack bounty with rifle
(the bounty hunter with the laser rifle)
the clone warrior says "The bounty hunter is a friend. I would sooner fight you!"

The clone warrior is unable to do that.

Yoda attacks the clone warrior with the green light sabre, causing 7 points of damage!

The clone warrior attacks Yoda with the laser rifle, causing 2 points of damage!

The bounty hunter attacks you with the bounty blaster, causing 1 point of damage!

* * *

StarWords
An Interactive Fiction by Campbell Burgess
Release 1 / Serial number 130914 / Inform 7 build 6G60 (I6/v6.32 lib 6/12N) SD

Training Room
A place to practice jedi skills.  There is a door to the north and an exit to the south. There is a bench by the wall.

Drong is here.

Yoda is here.

>yoda, fight drong
(with the green light sabre)
Yoda says "Drong is a friend. I would sooner fight you!"

Yoda attacks Drong with the green light sabre, causing 2 points of damage!

* * *

StarWords
An Interactive Fiction by Campbell Burgess
Release 1 / Serial number 130914 / Inform 7 build 6G60 (I6/v6.32 lib 6/12N) SD

Training Room
A place to practice jedi skills.  There is a door to the north and an exit to the south. There is a bench by the wall.

Drong is here.

Yoda is here.

>yoda, track me
Yoda tracks yourself

* * *

StarWords
An Interactive Fiction by Campbell Burgess
Release 1 / Serial number 130914 / Inform 7 build 6G60 (I6/v6.32 lib 6/12N) SD

Training Room
A place to practice jedi skills.  There is a door to the north and an exit to the south. There is a bench by the wall.

Drong is here.

Yoda is here.

>drong, spar with me
(with the blue light sabre)
Drong spars with yourself with the blue light sabre
Drong's experience points increases by -1.

* * *

StarWords
An Interactive Fiction by Campbell Burgess
Release 1 / Serial number 130914 / Inform 7 build 6G60 (I6/v6.32 lib 6/12N) SD

Training Room
A place to practice jedi skills.  There is a door to the north and an exit to the south. There is a bench by the wall.

Drong is here.

Yoda is here.

>yoda, follow drong
There is no reply.

* * *

StarWords
An Interactive Fiction by Campbell Burgess
Release 1 / Serial number 130914 / Inform 7 build 6G60 (I6/v6.32 lib 6/12N) SD

Training Room
A place to practice jedi skills.  There is a door to the north and an exit to the south. There is a bench by the wall.

Drong is here.

Yoda is here.

>drong, spar with yoda
(with the blue light sabre)
Drong says "I would prefer to spar with you!"

Drong spars with Yoda with the blue light sabre
Drong's experience points increases by 1.

* * *

StarWords
An Interactive Fiction by Campbell Burgess
Release 1 / Serial number 130914 / Inform 7 build 6G60 (I6/v6.32 lib 6/12N) SD

Training Room
A place to practice jedi skills.  There is a door to the north and an exit to the south. There is a bench by the wall.

Drong is here.

Yoda is here.

>yoda, spar with drong
(with the green light sabre)
Yoda spars with Drong with the green light sabre

>yoda, spar with drong
(with the green light sabre)
Yoda spars with Drong with the green light sabre

>drong, spar with yoda
(with the blue light sabre)
Drong spars with Yoda with the blue light sabre
Drong's experience points increases by 7.

>drong, spar with yoda
(with the blue light sabre)
Drong spars with Yoda with the blue light sabre
Drong's experience points increases by 8.

>drong, spar with yoda
(with the blue light sabre)
Drong spars with Yoda with the blue light sabre

>drong, spar with yoda
(with the blue light sabre)
Drong spars with Yoda with the blue light sabre

* * *

StarWords
An Interactive Fiction by Campbell Burgess
Release 1 / Serial number 130914 / Inform 7 build 6G60 (I6/v6.32 lib 6/12N) SD

Training Room
A place to practice jedi skills.  There is a door to the north and an exit to the south. There is a bench by the wall.

Drong is here.

Yoda is here.

>test table
(Testing.)

>[1] open left drawer
You open the left drawer, revealing a light sabre.

>[2] open right drawer
You open the right drawer, revealing a D battery.

>[3] get d battery
Taken.

>[4] get sabre
Taken.

>[5] put battery in sabre
(the D battery in the light sabre)
(first opening the light sabre)
(then closing the light sabre's battery compartment)

* * *

>press button
It is now on.

>kill me
(with the light sabre)
Don't be absurd.

"pop"

>yoda, kill yoda
(with the green light sabre)
Yoda  says "Don't be absurd."

Yoda is unable to do that.

"hrrrm"

* * *

>press button
It is now on.

>spar with yoda
(with the light sabre)
Yoda performs an elegant backflip to avoid your well aimed stroke.
Yoda says "You must unlearn what you have learned."

Your experience points increases by 10.  
"crackle"

>drong, spar with me
(with the blue light sabre)
Drong says "How about you spar with me!"

Drong spars with yourself with the blue light sabre
Drong's experience points increases by 0.

>drong, spar with me
(with the blue light sabre)
Drong says "How about you spar with me!"

Drong spars with yourself with the blue light sabre
Drong's experience points increases by 0.

>spar with yoda
(with the light sabre)
Yoda side steps your clumsy maneuver.
Yoda says "A Jedi must have the deepest commitment, the most serious mind. "

Your experience points increases by 0.

>spar with yoda
(with the light sabre)
Yoda strikes like a viper while seeming to hover outside your range.
Yoda says "To answer power with power, the Jedi way this is not. In this war, a danger there is, of losing who we are."

Your experience points increases by 4.  
"pop"

>spar with yoda
(with the light sabre)
Yoda easilly evades your reach.
Yoda says "Truly how wonderful the mind of a child is."

Your experience points increases by 2.  
"crackle"

>spar with yoda
(with the light sabre)
Yoda side steps your clumsy maneuver.
Yoda says "A Jedi's strength flows from the Force."

Your experience points increases by 0.  
"hrrrm"

>spar with yoda
(with the light sabre)
Yoda performs an elegant backflip to avoid your well aimed stroke.
Yoda says "Death is a natural part of life. Rejoice for those around you who transform into the Force. Mourn them do not. Miss them do not. Attachment leads to jealously. The shadow of greed, that is."

Your experience points increases by 1.  
"vrrrm"

>spar with yoda
(with the light sabre)
Yoda strikes like a viper while seeming to hover outside your range.
Yoda says "You must unlearn what you have learned."

Your experience points increases by 7.  
"snap"

>spar with yoda
(with the light sabre)
Yoda easilly evades your reach.
Yoda says "Named must your fear be before banish it you can."

Your experience points increases by 7.

>drong, spar with me
(with the blue light sabre)
Drong says "How about you spar with me!"

Drong spars with yourself with the blue light sabre
Drong's experience points increases by 0.

>drong, spar with me
(with the blue light sabre)
Drong says "How about you spar with me!"

Drong spars with yourself with the blue light sabre
Drong's experience points increases by 1.

>drong, spar with me
(with the blue light sabre)
Drong says "How about you spar with me!"

Drong spars with yourself with the blue light sabre
Drong's experience points increases by 0.  
"pop"

>drong, spar with me
(with the blue light sabre)
Drong says "How about you spar with me!"

Drong spars with yourself with the blue light sabre
Drong's experience points increases by 1.

>drong, spar with yoda
(with the blue light sabre)
Drong says "I would prefer to spar with you!"

Drong spars with Yoda with the blue light sabre
Drong's experience points increases by 2.

>drong, spar with yoda
(with the blue light sabre)
Drong says "I would prefer to spar with you!"

Drong spars with Yoda with the blue light sabre
Drong's experience points increases by 3.  
"wrrym"

>drong, spar with yoda
(with the blue light sabre)
Drong says "I would prefer to spar with you!"

Drong spars with Yoda with the blue light sabre
Drong's experience points increases by 1.

>drong, spar with yoda
(with the blue light sabre)
Drong says "I would prefer to spar with you!"

Drong spars with Yoda with the blue light sabre
Drong's experience points increases by 5.  
"snap"

>drong, spar with yoda
(with the blue light sabre)
Drong says "I would prefer to spar with you!"

Drong spars with Yoda with the blue light sabre

"hrrrm"

* * *

>spar with yoda
(with the light sabre)
Yoda performs an elegant backflip to avoid your well aimed stroke.
Yoda says "You must unlearn what you have learned."

Your experience points increases by 10.  
"crackle"

>spar with yoda
(with the light sabre)
Yoda strikes like a viper while seeming to hover outside your range.
Yoda says "Clear your mind must be, if you are to find the villains behind this plot."

Your experience points increases by 7.  
"pop"

>spar with yoda
(with the light sabre)
Yoda easilly evades your reach.
Yoda says "I cannot teach him. The boy has no patience."

Your experience points increases by 8.  
"hrrrm"

I beg your pardon?

>spar with yoda
(with the light sabre)
Yoda performs an elegant backflip to avoid your well aimed stroke.
Yoda says "You will find only what you bring in."

Your experience points increases by 6.  
"snap"

>spar with yoda
(with the light sabre)
Yoda side steps your clumsy maneuver.
Yoda says "Secret, shall I tell you?  Grand Master of Jedi Order am I. Won this job in a raffle I did, think you? "How did you know, how did you know, Master Yoda?" Master Yoda knows these things. His job it is."

Your experience points increases by 4.

>spar with yoda
(with the light sabre)
Yoda strikes like a viper while seeming to hover outside your range.
Yoda says "Through the Force, things you will see. Other places. The future...the past. Old friends long gone. "

Your experience points increases by 1.

>spar with yoda
(with the light sabre)
Yoda easilly evades your reach.
Yoda says "You will find only what you bring in."

Your experience points increases by 6.  Yoda says "You're training is now complete!".  The force feels stronger in you now.  Drong will be you new padawan, Master Keav

>drong, spar with me
(with the blue light sabre)
Drong spars with yourself with the blue light sabre
Drong's experience points increases by 0.

>drong, spar with me
(with the blue light sabre)
Drong spars with yourself with the blue light sabre
Drong's experience points increases by 3.

"snap"

>drong, spar with me
(with the blue light sabre)
Drong spars with yourself with the blue light sabre
Drong's experience points increases by 1.

>drong, spar with me
(with the blue light sabre)
Drong spars with yourself with the blue light sabre
Drong's experience points increases by 1.

>drong, spar with me
(with the blue light sabre)
Drong spars with yourself with the blue light sabre
Drong's experience points increases by 0.

>drong, spar with yoda
(with the blue light sabre)
Drong spars with Yoda with the blue light sabre
Drong's experience points increases by 6.

"snap"

>drong, spar with yoda
(with the blue light sabre)
Drong spars with Yoda with the blue light sabre

>s
Arena
Sand, blood, iron. These festivals are normally held on hot days, but the sun has gone behind a cloud and fat drops of rain now and then spatter the arena floor.

A clone warrior faces you, wielding a laser rifle and a clone blaster.

A bounty hunter circles you, pointing a shock rifle and a bounty blaster.

The clone warrior attacks you with the clone blaster, causing 0 points of damage!

The bounty hunter attacks you with the bounty blaster, causing 5 points of damage!

Drong arrives from the north.

"wrrym"

>hit yoda with sabre
You can't see any such thing.

>hit hunter with sabre
You attack the bounty hunter with the light sabre, causing 9 points of damage!

Drong attacks the bounty hunter with the blue light sabre, causing 4 points of damage!

The clone warrior attacks you with the laser rifle, causing 0 points of damage!

The bounty hunter attacks Drong with the bounty blaster, causing 3 points of damage!

>hit hunter with sabre
You attack with the light sabre, killing the bounty hunter!

Drong attacks the clone warrior with the blue light sabre, causing 4 points of damage!

The clone warrior attacks Drong with the clone blaster, causing 0 points of damage!

>hit clone with sabre
(the clone warrior with the light sabre)
You attack the clone warrior with the light sabre, causing 1 point of damage!
Looks like the clone warrior is taking this personally.

Drong attacks the clone warrior with the blue light sabre, causing 0 points of damage!

The clone warrior attacks Drong with the clone blaster, causing 4 points of damage!

"vrrrm"

>hit clone with sabre
(the clone warrior with the light sabre)
You attack the clone warrior with the light sabre, causing 3 points of damage!

Drong attacks the clone warrior with the blue light sabre, causing 0 points of damage!

The clone warrior attacks you with the laser rifle, causing 5 points of damage!

"pop"

>n
Training Room
A place to practice jedi skills.  There is a door to the north and an exit to the south. There is a bench by the wall.

Yoda is here.

Drong arrives from the south.

The clone warrior arrives from the south.

>clone, spar with drong
What do you want the clone warrior to spar with Drong with?

>clone, spar with drong with blaster
There is no reply.

The clone warrior attacks Yoda with the laser rifle, causing 7 points of damage!

Drong attacks the clone warrior with the blue light sabre, causing 2 points of damage!

Yoda attacks the clone warrior with the green light sabre, causing 1 point of damage!

>clone, attack drong with blaster
The clone warrior attacks Drong with the clone blaster, causing 3 points of damage!

The clone warrior attacks Drong with the laser rifle, causing 3 points of damage!

Drong attacks the clone warrior with the blue light sabre, causing 1 point of damage!

Yoda attacks the clone warrior with the green light sabre, causing 1 point of damage!

>clone, attack yoda with rifle
The clone warrior attacks Yoda with the laser rifle, causing 7 points of damage!

The clone warrior attacks Drong with the clone blaster, causing 5 points of damage!

Drong attacks the clone warrior with the blue light sabre, causing 4 points of damage!

Yoda attacks the clone warrior with the green light sabre, causing 3 points of damage!

>clone, attack yoda with rifle
The clone warrior attacks Yoda with the laser rifle, causing 1 point of damage!

The clone warrior attacks Yoda with the clone blaster, causing 5 points of damage!

Drong attacked the clone warrior with the blue light sabre, killing the clone warrior!

"wrrym"

>clone, attack yoda with rifle
You can't talk to the clone blaster.

* * *

>spar with yoda
(with the light sabre)
Yoda performs an elegant backflip to avoid your well aimed stroke.
Yoda says "You must unlearn what you have learned."

Your experience points increases by 10.  
"crackle"

>yoda, spar with drong
(with the green light sabre)
Yoda says "I would prefer to spar with you!"

>yoda, spar with me
(with the green light sabre)
Yoda says "How about you spar with me!"

"wrrym"

* * *

>press button
It is now on.

>yoda, follow me
There is no reply.

"crackle"

* * *

StarWords
An Interactive Fiction by Campbell Burgess
Release 1 / Serial number 130914 / Inform 7 build 6G60 (I6/v6.32 lib 6/12N) SD

Training Room
A place to practice jedi skills.  There is a door to the north and an exit to the south. There is a bench by the wall.

Drong is here.

Yoda is here.

>Yoda, follow me
Yoda says "Ok, I will follow yourself."

* * *

StarWords
An Interactive Fiction by Campbell Burgess
Release 1 / Serial number 130914 / Inform 7 build 6G60 (I6/v6.32 lib 6/12N) SD

Training Room
A place to practice jedi skills.  There is a door to the north and an exit to the south. There is a bench by the wall.

Drong is here.

Yoda is here.

>yoda, fight me
(with the green light sabre)
Yoda  says "I will not fight you, my friend.

Yoda is unable to do that.

* * *

StarWords
An Interactive Fiction by Campbell Burgess
Release 1 / Serial number 130914 / Inform 7 build 6G60 (I6/v6.32 lib 6/12N) SD

Training Room
A place to practice jedi skills.  There is a door to the north and an exit to the south. There is a bench by the wall.

Drong is here.

Yoda is here.

>yoda, fight yoda
(with the green light sabre)
Yoda  says "Don't be absurd."

Yoda is unable to do that.

>yoda, fight me
(with the green light sabre)
Yoda  says "That is not possible."

Yoda is unable to do that.